amongst মধ্যে
amoral অনৈতিক
amount পরিমাণ
amplify বিবর্ধন
amplitude বিস্তার
amusement আমোদ-প্রমোদ
amusing মজাদার
an একটি
expectedly প্রত্যাশিতভাবে
expecting প্রত্যাশা করা হচ্ছে
expedite ত্বরান্বিত করা
expel বহিষ্কার করা
expenditure খরচ
expense খরচ
expenses খরচা
expensive মূল্যবান
expensive দামী
experience অভিজ্ঞতা
experience অনুভব করা
experience অভিজ্ঞতা হওয়া
experienced অভিজ্ঞ
experiment পরীক্ষা
experimental পরীক্ষামূলক
expert বিশেষজ্ঞ
expert বিশেষজ্ঞ
experts বিশেষজ্ঞরা
expiration তামাদি
expire তামাদি হওয়া
explain ব্যাখ্যা করা
bond বন্ধন করা
born জন্ম নেওয়া
bother বিরক্ত করা
bring আনা
browse ব্রাউজ করা
buy কেনা
calculate গণনা করা
cancel বাতিল করা
describe বর্ণনা করা
destroy ধ্বংস করা
detach বিচ্ছিন্ন করা
detect সনাক্ত করা
determine নির্ধারণ করা
detonate বিস্ফোরিত করা
develop বিকশিত করা
dial ডায়াল করা
dialogue কথোপকথন করা
differ ভিন্নমত হওয়া
disable নিষ্ক্রিয় করা
disappear অন্তর্ধান করা
discard বাতিল করা
discuss আলোচনা করা
hoist উত্তোলন করা
pity সমবেদনা
bard কবি
scarf ওড়না
me স্বয়ং
sly চালাক
sly চতুর
cilantro ধনে পাতা‌
see দেখা
marchants বণিক
moon চন্দ্র
isro ইসরো
up উপর
facebook ফেসবুক
i আমি
quark কোয়ার্ক
love ভালবাসা
risible মজাদার
disdain অবজ্ঞা করা
page পাতা
talk আলাপ
template টেমপ্লেট
featured নির্বাচিত
lintels চৌকাঠ
marinate জারক দেয়া
just মাত্র
just সঠিক
eat খাওয়া
gp জিপি
patient রোগী
procedures পদ্ধতি
visit সাক্ষাৎকার
index নির্ঘন্ট
judged বিচারিত
verifiable যাচাইযোগ্য
undue অসঙ্গত
good ভাল
re-use পুনর্ব্যবহার করা
outface মুখোমুখি হওয়া
sophisticated সুক্ষ্ন
sophisticated অপ্রকৃত
sophisticated কৃত্রিম
israeli ইজরায়েলী
lenin লেনিন
dictionary শব্দভাণ্ডার
king রাজা, নৃপতি
konok কনক
woman নারী
synchronus যুগপৎ
jackal শিয়াল
cuff চপেটাঘাত
morning প্রভাত
one একটি
study গবেষণা
research বিশ্লেষণ
spill পতন
gamma গামা
computer গণক যন্ত্র
up উচ্চতর
congee চালের পায়েস
jaguar জাগুয়ার
llama লামা
koala কোয়ালা
bedrooms শোবার ঘর
males ছেলে
standard মান
appliances সরঞ্জামাদি
rooms ঘর
candidates আবেদনকারী
organised আয়োজিত
maximum সর্বোচ্চ
micro-oven মাইক্রো ওভেন
poor গরীব
solidarity সংহতি
thorn কন্টক
banned নিষিদ্ধ
non-controversial অবিতর্কিত
cleanup পরিষ্করণ
routine স্বাভাবিক
non-existent অবিদ্যমান
professional পেশাজীবি
saunf মৌরি
silver রজত
recognized পরিচিত
enduring স্থায়ী
scholars পন্ডিত
championships চ্যাম্পিয়নশিপ
personalities ব্যক্তিত্ব
large অনেক
adroitness দক্ষতা
intonation স্বরভেদ
halcyon মাছরাঙা
doctor চিকিৎসক
guidelines নীতি নির্দেশাবলী
climate জলবায়ু 
change পরিবর্তন
promise প্রতিজ্ঞা
abraham আব্রাহাম
pillar অবলম্বন
failure অকৃতকার্যতা
fain সানন্দে
faint নিস্তেজ
aback আশ্চার্যান্বিত
abaddon নরক
abashed অপ্রতিভ
acts আইন
lightsome আলোকিত
ethic নীতিশাস্ত্র
office দপ্তর
judges বিচারপতি
sub-national উপ-জাতীয়
first-level প্রথম স্তর
citywide শহর ব্যাপি
speaking বলা হয়
insufficiency অপর্যাপ্ততা
poor দূর্বল
muslims মুসলমান
section অনুচ্ছেদ
entrapped ফাঁদে পড়া
wahhabis ওহাবী
condensation সংক্ষেপন
sperm শুক্র
aversion বিরক্তি
consensus ঐকমত্য
pillar স্তম্ভ
ruleset নীতিবিন্যাস
foundation প্রতিষ্ঠান
resolution নিরসন
dispute সংঘাত
memory স্মৃতি
prone প্রবণ
topic আলোচ্য বিষয়
references তথ্যসূত্র
publications প্রকাশনা
rabbits খরগোশ
webspace ওয়েব স্পেস
landline ল্যান্ডলাইন
verdict বিচারক এর রায়
congruent সমাপতিত
squirrels কাঠবিড়ালী
snakes সাপ
edible ভক্ষ্য
such এই রকম
e-mail ইমেল
wikimedia উইকিমিডিয়া
colon কোলন
mediawiki মিডিয়াউইকি
prefix উপসর্গ
encyclopedia বিশ্বকোষ
namespace নামস্থান
politician রাজনীতিবিদ
department দপ্তর
community সম্প্রদায়
skills দক্ষতা
tidbit জনশ্রুতির মুখোরচক অংশ
cute সুন্দর
promise প্রতিশ্রুতি
eternal চিরন্তন শাশ্বত
eternal অমর
acknowledge স্বীকার করা
gratuitously বিনামুল্যে
sins পাপ
desperate বেপরোয়া
gifts উপহার
justification যথাযথতা
promising অঙ্গীকারপূর্ণ
porn অশ্লীল
shell শেল
rape ধর্ষণ
draught বায়ু-স্রোত
draught টানা
microorganisms জীবাণু
disinfect জীবাণুমুক্ত করা
salty লবণাক্ত
stratosphere বায়ুমণ্ডলের স্তরবিশেষ
umpire সালিসি
farm খামার
sterile নিঃসন্তান
sterile বাঁঝা
argue বাদানুবাদ করা
accretion পরিবৃদ্ধি
add যোগকরা
add একত্র করা
above-mentioned পূর্বোল্লিখিত
abdoman উদর
abdoman তলপেট
adieu বিদায় সম্ভাষণ
adder ইউরোপের এক ধরণের ছোট বিষ ধর সাপ
absorbent শোষক পদার্থ
abort গর্ভস্রাব হওয়া
abort ত্যাগ করা
acidify অম্ল করা
admire শ্রদ্ধা করা
admonishment সতর্কী করণ
admonishment তিরষ্কার
admonishment উপদেশ
admiral নৌ বহরের অধ্যক্ষ
abolionist কোন কিছু উচ্ছেদ করার সমর্থক
acute সংকট জনক
younger কচি
warship রণতরী
wastage অপচয়
worn-out ক্লান্ত
westernmost সর্ব-পশ্চিমে অবস্থিত
visual দৃষ্টিগোচর
withstand প্রতিরোধ করা
women স্ত্রীলোক
women নারী
voluble বাচাল
voluble অনর্গল বক্তৃতা দিতে পারে এমন
wicked পাপী
wizard যাদুকর
wood-nymph বনপরী
volley-ball ভলিবল
wave ঢেউ
wave প্রবাহ
yclept অভিহিত
vitroil সালফিউরিক অ্যাসিড
zodiac রাশিচক্র
xanthippe মুখরা রমনী
virgo কন্যারাশি
wimple সন্ন্যাসিনীর ঘোমটাবিশেষ
wicker-work কঞ্চি দ্বারা নির্মিত দ্রব্য
wilness কপটতা
yard-stick গজকাঠি
vocabulary অভিধান
weariness অবসাদ
woo বিবাহের প্রস্তাব করা
wail বিলাপ
a	এক
abandon	পরিত্যাগ করা
ability	ক্ষমতা
able	সক্ষম
abortion	গর্ভপাত
about	সম্পর্কিত
above	উপরে
abroad	বিদেশে
absence	অনুপস্থিতি
absolute	পরম
absolutely	একেবারে
absorb	শোষণ
abuse	অপব্যবহার
academic	একাডেমিক
accept	গ্রহণ
access	প্রবেশাধিকার
accident	দুর্ঘটনা
accompany	সঙ্গী করা
accomplish	সম্পন্ন
according	অনুসারে
account	অ্যাকাউন্ট
accurate	সঠিক
accuse	অভিযুক্ত করা
achieve	অর্জন
achievement	অর্জন
acid	অ্যাসিড
acknowledge	স্বীকার
acquire	অর্জন
across	জুড়ে
act	আইন
action	কর্ম
active	সক্রিয়
activist	কর্মী
activity	কার্যকলাপ
actor	অভিনেতা
actress	অভিনেত্রী
actual	আসল
actually	আসলে
ad	বিজ্ঞাপন
adapt	মানিয়ে নেওয়া
add	যোগ করুন
addition	যোগ
additional	অতিরিক্ত
address	ঠিকানা
adequate	পর্যাপ্ত
adjust	সামঞ্জস্য করা
adjustment	সমন্বয়
administration	প্রশাসন
administrator	প্রশাসক
admire	প্রশংসা করা
admission	ভর্তি
admit	স্বীকার
adolescent	কিশোর
adopt	গ্রহণ
adult	প্রাপ্তবয়স্ক
advance	আগাম
advanced	উন্নত
advantage	সুবিধা
adventure	দু: সাহসিক কাজ
advertising	বিজ্ঞাপন
advice	উপদেশ
advise	উপদেশ
adviser	উপদেষ্টা
advocate	উকিল
affair	ব্যাপার
affect	প্রভাবিত
afford	সামর্থ্য
afraid	ভীত
African	আফ্রিকান
African-American	আফ্রিকান আমেরিকান
after	পরে
afternoon	বিকেল
again	আবার
against	বিরুদ্ধে
age	বয়স
agency	এজেন্সি
agenda	আলোচ্যসূচি
agent	প্রতিনিধি
aggressive	আক্রমণাত্মক
ago	আগে
agree	একমত
agreement	চুক্তি
agricultural	কৃষি
ahead	সামনে
aid	সাহায্য
aide	সহায়ক
AIDS	এইডস
aim	লক্ষ্য
air	বায়ু
aircraft	বিমান
airline	এয়ারলাইন
airport	বিমানবন্দর
album	অ্যালবাম
alcohol	অ্যালকোহল
alive	জীবিত
all	সব
alliance	জোট
allow	অনুমতি দিন
ally	মিত্র
almost	প্রায়
alone	একা
along	বরাবর
already	ইতিমধ্যে
also	এছাড়াও
alter	পরিবর্তন
alternative	বিকল্প
although	যদিও
always	সর্বদা
am	আমি
amazing	আশ্চর্যজনক
American	মার্কিন
among	মধ্যে
amount	পরিমাণ
an	একটি
analysis	বিশ্লেষণ
analyst	বিশ্লেষক
analyze	বিশ্লেষণ
ancient	প্রাচীন
and	এবং
anger	রাগ
angle	কোণ
angry	রাগী
animal	পশু
anniversary	বার্ষিকী
announce	ঘোষণা করা
annual	বার্ষিক
another	অন্য
answer	উত্তর
anticipate	পূর্বানুমান
anxiety	উদ্বেগ
any	কোন
anybody	যে কেউ
anymore	আর
anyone	যে কেউ
anything	কিছু
anyway	যাই হোক
anywhere	যে কোন জায়গায়
apart	পৃথক্
apartment	অ্যাপার্টমেন্ট
apparent	স্পষ্ট
apparently	দৃশ্যত
appeal	আপীল
appear	প্রদর্শিত
appearance	চেহারা
apple	আপেল
application	আবেদন
apply	প্রযোজ্য
appoint	নিয়োগ
appointment	নিয়োগ
appreciate	প্রশংসা
approach	পন্থা
appropriate	যথাযথ
approval	অনুমোদন
approve	অনুমোদন
approximately	আন্দাজ
Arab	আরব
architect	স্থপতি
are	হয়
area	এলাকা
argue	তর্ক
argument	যুক্তি
arise	উত্থান
arm	বাহু
armed	সশস্ত্র
army	সেনাবাহিনী
around	কাছাকাছি
arrange	ব্যবস্থা করা
arrangement	ব্যবস্থা
arrest	গ্রেফতার
arrival	আগমন
arrive	পৌঁছান
art	শিল্প
article	নিবন্ধ
artist	শিল্পী
artistic	শৈল্পিক
as	হিসাবে
Asian	এশিয়ান
aside	একপাশে
ask	জিজ্ঞাসা
asleep	ঘুমিয়ে
aspect	দিক
assault	লাঞ্ছনা
assert	জাহির করা
assess	মূল্যায়ন
assessment	মূল্যায়ন
asset	সম্পদ
assign	বরাদ্দ করা
assignment	নিয়োগ
assist	সাহায্য
assistance	সহায়তা
assistant	সহকারী
associate	সহযোগী
association	সংঘ
assume	অনুমান
assumption	ধৃষ্টতা
assure	আশ্বাস
at	এ
athlete	ক্রীড়াবিদ
athletic	ক্রীড়াবিদ
atmosphere	বায়ুমণ্ডল
atom	পরমাণু
attach	সংযুক্ত করুন
attack	আক্রমণ
attempt	চেষ্টা
attend	উপস্থিত
attention	মনোযোগ
attitude	মনোভাব
attorney	উকিল
attract	আকর্ষণ
attractive	আকর্ষণীয়
attribute	বৈশিষ্ট্য
audience	শ্রোতা
author	লেখক
authority	কর্তৃত্ব
auto	স্বয়ংক্রিয়
available	উপলব্ধ
average	গড়
avoid	এড়াতে
award	পুরস্কার
aware	সচেতন
awareness	সচেতনতা
away	দূরে
awful	ভয়াবহ, আতঙ্কজনক
baby	বাচ্চা
back	পেছনে
background	পটভূমি
bad	খারাপ
badly	খারাপভাবে
bag	থলে
bake	বেক
balance	ভারসাম্য
ball	বল
ban	নিষেধাজ্ঞা
band	ব্যান্ড
bank	ব্যাংক
bar	বার
barely	সবে
barrel	ব্যারেল
barrier	বাধা
base	ভিত্তি
baseball	বেসবল
basic	মৌলিক
basically	মূলত
basis	ভিত্তি
basket	ঝুড়ি
basketball	বাস্কেটবল
bat	ব্যাট
bathroom	পায়খানা
battery	ব্যাটারি
battle	যুদ্ধ
be	থাকা
beach	সৈকত
bean	শিম
bear	ভালুক
beat	বীট
beautiful	সুন্দর
beauty	সৌন্দর্য
because	কারণ
become	হয়ে
bed	বিছানা
bedroom	শয়নকক্ষ
been	হয়েছে
beer	বিয়ার
before	আগে
began	শুরু হয়েছিল
begin	শুরু
beginning	শুরু
behavior	আচরণ
behind	পিছনে
being	হচ্ছে
belief	বিশ্বাস
believe	বিশ্বাস
bell	ঘণ্টা
belong	অন্তর্গত
below	নিচে
belt	বেল্ট
bench	এজলাস
bend	বাঁক
beneath	নীচে
benefit	উপকার
beside	পাশে
besides	ছাড়াও
best	সেরা
bet	বাজি
better	উত্তম
between	মধ্যে
beyond	তার পরেও
Bible	বাইবেল
big	বড়
bike	বাইক
bill	বিল
billion	বিলিয়ন
bind	বাঁধাই করা
biological	জৈবিক
bird	পাখি
birth	জন্ম
birthday	জন্মদিন
bit	বিট
bite	কামড়
black	কালো
blade	ব্লেড
blame	দোষ
blanket	কম্বল
blind	অন্ধ
block	ব্লক
blood	রক্ত
blow	আঘাত
blue	নীল
board	বোর্ড
boat	নৌকা
body	শরীর
bomb	বোমা
bombing	বোমা হামলা
bond	বন্ধন
bone	হাড়
book	বই
boom	বুম
boot	বুট
border	সীমানা
born	জন্ম
borrow	ধার করা
boss	বস
both	উভয়
bother	বিরক্ত
bottle	বোতল
bottom	নীচে
bought	কিনলেন
boundary	সীমানা
bowl	বাটি
box	বাক্স
boy	ছেলে
boyfriend	প্রেমিক
brain	মস্তিষ্ক
branch	শাখা
brand	ব্র্যান্ড
bread	রুটি
break	বিরতি
breakfast	প্রাত breakfastরাশ
breast	স্তন
breath	শ্বাস
breathe	শ্বাস ফেলা
brick	ইট
bridge	সেতু
brief	সংক্ষিপ্ত
briefly	সংক্ষেপে
bright	উজ্জ্বল
brilliant	উজ্জ্বল
bring	আনা
British	ব্রিটিশ
broad	বিস্তৃত
broke	ভেঙ্গে
broken	ভাঙ্গা
brother	ভাই
brought	আনা হয়েছে
brown	বাদামী
brush	ব্রাশ
buck	বক
budget	বাজেট
build	নির্মাণ
building	বিল্ডিং
bullet	বুলেট
bunch	গুচ্ছ
burden	বোঝা
burn	পোড়া
bury	কবর
bus	বাস
business	ব্যবসা
busy	ব্যস্ত
but	কিন্তু
butter	মাখন
button	বোতাম
buy	কেনা
buyer	ক্রেতা
by	দ্বারা
cabin	কেবিন
cabinet	মন্ত্রিসভা
cable	তারের
cake	পিষ্টক
calculate	গণনা
call	কল
came	এসেছিল
camera	ক্যামেরা
camp	শিবির
campaign	প্রচার
campus	ক্যাম্পাস
can	করতে পারা
Canadian	কানাডিয়ান
cancer	ক্যান্সার
candidate	প্রার্থী
cap	টুপি
capability	ক্ষমতা
capable	সক্ষম
capacity	ক্ষমতা
capital	মূলধন
captain	অধিনায়ক
capture	ক্যাপচার
car	গাড়ী
carbon	কার্বন
card	কার্ড
care	যত্ন
career	কর্মজীবন
careful	সাবধান
carefully	সাবধানে
carrier	বাহক
carry	বহন
case	কেস
cash	নগদ
cast	নিক্ষেপ
cat	বিড়াল
catch	ধরা
category	বিভাগ
Catholic	ক্যাথলিক
caught	ধরা
cause	কারণ
ceiling	সিলিং
celebrate	উদযাপন
celebration	উদযাপন
celebrity	সেলিব্রিটি
cell	কোষ
cent	শতক
center	কেন্দ্র
central	কেন্দ্রীয়
century	শতাব্দী
CEO	সিইও
ceremony	অনুষ্ঠান
certain	নিশ্চিত
certainly	অবশ্যই
chain	চেইন
chair	চেয়ার
chairman	চেয়ারম্যান
challenge	চ্যালেঞ্জ
chamber	চেম্বার
champion	রক্ষক
championship	চ্যাম্পিয়নশিপ
chance	সুযোগ
change	পরিবর্তন
changing	পরিবর্তন
channel	চ্যানেল
chapter	অধ্যায়
character	চরিত্র
characteristic	বৈশিষ্ট্য
characterize	বৈশিষ্ট্য
charge	চার্জ
charity	দানশীলতা
chart	চার্ট
chase	পশ্চাদ্ধাবন
cheap	সস্তা
check	চেক
cheek	গাল
cheese	পনির
chef	পাচক
chemical	রাসায়নিক
chest	বুক
chick	ছানা
chicken	মুরগি
chief	প্রধান
child	শিশু
childhood	শৈশব
children	শিশু
Chinese	চীনা
chip	চিপ
chocolate	চকলেট
choice	পছন্দ
cholesterol	কোলেস্টেরল
choose	পছন্দ করা
chord	জ্যোতি
Christian	খ্রিস্টান
Christmas	বড়দিন
church	গির্জা
cigarette	সিগারেট
circle	বৃত্ত
circumstance	পরিস্থিতি
cite	উদ্ধৃতি
citizen	নাগরিক
city	শহর
civil	নাগরিক
civilian	বেসামরিক
claim	দাবি
class	শ্রেণী
classic	ক্লাসিক
classroom	শ্রেণীকক্ষ
clean	পরিষ্কার
clear	পরিষ্কার
clearly	পরিষ্কারভাবে
client	ক্লায়েন্ট
climate	জলবায়ু
climb	আরোহণ
clinic	ক্লিনিক
clinical	ক্লিনিকাল
clock	ঘড়ি
close	বন্ধ
closely	ঘনিষ্ঠভাবে
closer	কাছাকাছি
clothe	কাপড়
clothes	বস্ত্র
clothing	পোশাক
cloud	মেঘ
club	ক্লাব
clue	সূত্র
cluster	গুচ্ছ
coach	কোচ
coal	কয়লা
coalition	জোট
coast	উপকূল
coat	কোট
code	কোড
coffee	কফি
cognitive	জ্ঞান ভিত্তিক
cold	ঠান্ডা
collapse	পতন
colleague	সহকর্মী
collect	সংগ্রহ
collection	সংগ্রহ
collective	সমষ্টিগত
college	কলেজ
colonial	পনিবেশিক
colony	উপনিবেশ
color	রঙ
column	কলাম
combination	সমন্বয়
combine	একত্রিত করা
come	আসা
comedy	কমেডি
comfort	আরাম
comfortable	আরামপ্রদ
command	কমান্ড
commander	কমান্ডার
comment	মন্তব্য
commercial	ব্যবসায়িক
commission	কমিশন
commit	অঙ্গীকার করা
commitment	অঙ্গীকার
committee	কমিটি
common	সাধারণ
communicate	যোগাযোগ
communication	যোগাযোগ
community	সম্প্রদায়
company	প্রতিষ্ঠান
compare	তুলনা করা
comparison	তুলনা
compete	প্রতিদ্বন্দ্বিতা করা
competition	প্রতিযোগিতা
competitive	প্রতিযোগিতামূলক
competitor	প্রতিদ্বন্দ্বী
complain	অভিযোগ
complaint	অভিযোগ
complete	সম্পূর্ণ
completely	সম্পূর্ণরূপে
complex	জটিল
complicated	জটিল
component	উপাদান
compose	রচনা করা
composition	গঠন
comprehensive	ব্যাপক
computer	কম্পিউটার
concentrate	মনোনিবেশ
concentration	একাগ্রতা
concept	ধারণা
concern	উদ্বেগ
concerned	সংশ্লিষ্ট
concert	কনসার্ট
conclude	উপসংহার
conclusion	উপসংহার
concrete	কংক্রিট
condition	অবস্থা
conduct	পরিচালনা
conference	সম্মেলন
confidence	আত্মবিশ্বাস
confident	আত্মবিশ্বাসী
confirm	নিশ্চিত করুন
conflict	দ্বন্দ্ব
confront	মোকাবেলা
confusion	বিভ্রান্তি
Congress	কংগ্রেস
congressional	কংগ্রেসনাল
connect	সংযোগ
connection	সংযোগ
consciousness	চেতনা
consensus	ঐকমত্য
consequence	ফলাফল
conservative	রক্ষণশীল
consider	বিবেচনা
considerable	যথেষ্ট
consideration	বিবেচনা
consist	গঠিত
consistent	সামঞ্জস্যপূর্ণ
consonant	ব্যঞ্জনবর্ণ
constant	ধ্রুবক
constantly	ক্রমাগত
constitute	গঠন করা
constitutional	সাংবিধানিক
construct	নির্মাণ
construction	নির্মাণ
consultant	পরামর্শদাতা
consume	গ্রাস করা
consumer	ভোক্তা
consumption	খরচ
contact	যোগাযোগ
contain	ধারণ করে
container	ধারক
contemporary	সমসাময়িক
content	বিষয়বস্তু
contest	প্রতিযোগিতা
context	প্রসঙ্গ
continent	মহাদেশ
continue	চালিয়ে যান
continued	অব্যাহত
contract	চুক্তি
contrast	বৈপরীত্য
contribute	অবদান
contribution	অবদান
control	নিয়ন্ত্রণ
controversial	বিতর্কিত
controversy	বিতর্ক
convention	সম্মেলন
conventional	প্রচলিত
conversation	কথোপকথন
convert	রূপান্তর
conviction	দৃঢ় বিশ্বাস
convince	সন্তুষ্ট
cook	রান্না
cookie	কুকি
cooking	রান্না
cool	শীতল
cooperation	সহযোগিতা
cop	পুলিশ
cope	সামলাতে
copy	কপি
core	মূল
corn	ভুট্টা
corner	কোণ
corporate	কর্পোরেট
corporation	কর্পোরেশন
correct	সঠিক
correspondent	সংবাদদাতা
cost	খরচ
cotton	তুলা
couch	পালঙ্ক
could	পারে
council	পরিষদ
counselor	পরামর্শদাতা
count	গণনা
counter	পাল্টা
country	দেশ
county	কাউন্টি
couple	দম্পতি
courage	সাহস
course	কোর্স
court	আদালত
cousin	চাচাতো ভাই
cover	আবরণ
coverage	কভারেজ
cow	গাভী
crack	ফাটল
craft	নৈপুণ্য
crash	ক্র্যাশ
crazy	পাগল
cream	ক্রিম
crease	ক্রিজ
create	সৃষ্টি
creation	সৃষ্টি
creative	সৃজনশীল
creature	প্রাণী
credit	ক্রেডিট
crew	নাবিকদল
crime	অপরাধ
criminal	অপরাধী
crisis	সংকট
criteria	নির্ণায়ক
critic	সমালোচক
critical	সমালোচনামূলক
criticism	সমালোচনা
criticize	সমালোচনা করা
crop	ফসল
cross	ক্রস
crowd	ভিড়
crucial	অত্যন্ত গুরুত্বপূর্ণ
cry	কান্না
cultural	সাংস্কৃতিক
culture	সংস্কৃতি
cup	কাপ
curious	কৌতূহলী
current	বর্তমান
currently	বর্তমানে
curriculum	পাঠ্যক্রম
custom	কাস্টম
customer	ক্রেতা
cut	কাটা
cycle	সাইকেল
dad	বাবা
daily	দৈনিক
damage	ক্ষতি
dance	নাচ
danger	বিপদ
dangerous	বিপজ্জনক
dare	সাহস
dark	অন্ধকার
darkness	অন্ধকার
data	তথ্য
date	তারিখ
daughter	কন্যা
day	দিন
dead	মৃত
deal	চুক্তি
dealer	ডিলার
dear	প্রিয়
death	মৃত্যু
debate	বিতর্ক
debt	দেনা
decade	দশক
decide	সিদ্ধান্ত নিন
decimal	দশমিক
decision	সিদ্ধান্ত
deck	ডেক
declare	ঘোষণা করা
decline	পতন
decrease	হ্রাস
deep	গভীর
deeply	গভীরভাবে
deer	হরিণ
defeat	পরাজয়
defend	রক্ষা করা
defendant	প্রতিবাদী
defense	প্রতিরক্ষা
defensive	আত্মরক্ষামূলক
deficit	ঘাটতি
define	সংজ্ঞায়িত করা
definitely	স্পষ্টভাবে
definition	সংজ্ঞা
degree	ডিগ্রী
delay	বিলম্ব
deliver	বিতরণ
delivery	ডেলিভারি
demand	চাহিদা
democracy	গণতন্ত্র
Democrat	গণতান্ত্রিক
democratic	গণতান্ত্রিক
demonstrate	প্রদর্শন
demonstration	প্রদর্শন
deny	অস্বীকার করা
department	বিভাগ
depend	নির্ভর
dependent	নির্ভরশীল
depending	নির্ভর করে
depict	চিত্রিত করা
depression	বিষণ্ণতা
depth	গভীরতা
deputy	সহকারী
derive	প্রাপ্ত
describe	বর্ণনা করা
description	বর্ণনা
desert	মরুভূমি
deserve	প্রাপ্য
design	নকশা
designer	নকশাকার
desire	ইচ্ছা
desk	ডেস্ক
desperate	মরিয়া
despite	সত্ত্বেও
destroy	ধ্বংস
destruction	ধ্বংস
detail	বিস্তারিত
detailed	বিশদ
detect	সনাক্ত করা
determine	নির্ধারণ
develop	বিকাশ
developing	উন্নয়নশীল
development	উন্নয়ন
device	যন্ত্র
devote	উৎসর্গ করা
dialogue	সংলাপ
dictionary	অভিধান
did	করেছিল
die	মারা
diet	খাদ্য
differ	ভিন্ন
difference	পার্থক্য
different	ভিন্ন
differently	ভিন্নভাবে
difficult	কঠিন
difficulty	অসুবিধা
dig	খনন করা
digital	ডিজিটাল
dimension	মাত্রা
dining	ডাইনিং
dinner	রাতের খাবার
direct	সরাসরি
direction	অভিমুখ
directly	সরাসরি
director	পরিচালক
dirt	ময়লা
dirty	নোংরা
disability	অক্ষমতা
disagree	অসম্মতি
disappear	অদৃশ্য
disaster	বিপর্যয়
discipline	শৃঙ্খলা
discourse	বক্তৃতা
discover	আবিষ্কার
discovery	আবিষ্কার
discrimination	বৈষম্য
discuss	আলোচনা করা
discussion	আলোচনা
disease	রোগ
dish	থালা
dismiss	খারিজ
disorder	ব্যাধি
display	প্রদর্শন
dispute	বিতর্ক
distance	দূরত্ব
distant	দূরবর্তী
distinct	স্বতন্ত্র
distinction	পার্থক্য
distinguish	পার্থক্য
distribute	বিতরণ
distribution	বন্টন
district	জেলা
diverse	বৈচিত্র্যময়
diversity	বৈচিত্র্য
divide	বিভক্ত করা
division	বিভাগ
divorce	বিবাহবিচ্ছেদ
DNA	ডিএনএ
do	কর
doctor	ডাক্তার
document	দলিল
does	করে
dog	কুকুর
dollar	ডলার
domestic	গার্হস্থ্য
dominant	প্রভাবশালী
dominate	আয়ত্ত করা
don’t	না
done	সম্পন্ন
door	দরজা
double	দ্বিগুণ
doubt	সন্দেহ
down	নিচে
downtown	শহরের কেন্দ্রস্থল
dozen	ডজন
draft	খসড়া
drag	টান
drama	নাটক
dramatic	নাটকীয়
dramatically	নাটকীয়ভাবে
draw	আঁকা
drawing	অঙ্কন
dream	স্বপ্ন
dress	পোষাক
drink	পান করা
drive	ড্রাইভ
driver	ড্রাইভার
drop	ড্রপ
drug	ড্রাগ
dry	শুকনো
duck	হাঁস
due	বাকি
during	সময়
dust	ধুলো
duty	দায়িত্ব
each	প্রতিটি
eager	আগ্রহী
ear	কান
early	তাড়াতাড়ি
earn	উপার্জন
earnings	উপার্জন
earth	পৃথিবী
ease	সহজ
easily	সহজে
east	পূর্ব
eastern	পূর্ব
easy	সহজ
eat	খাওয়া
economic	অর্থনৈতিক
economics	অর্থনীতি
economist	অর্থনীতিবিদ
economy	অর্থনীতি
edge	প্রান্ত
edition	সংস্করণ
editor	সম্পাদক
educate	শিক্ষিত করা
education	শিক্ষা
educational	শিক্ষাগত
educator	শিক্ষাবিদ
effect	প্রভাব
effective	কার্যকর
effectively	কার্যকরভাবে
efficiency	দক্ষতা
efficient	দক্ষ
effort	প্রচেষ্টা
egg	ডিম
eight	আট
either	হয়
elderly	বয়স্ক
elect	নির্বাচন
election	নির্বাচন
electric	বৈদ্যুতিক
electricity	বিদ্যুৎ
electronic	বৈদ্যুতিক
element	উপাদান
elementary	প্রাথমিক
eliminate	নিষ্কাশন করা
elite	অভিজাত
else	অন্য
elsewhere	অন্যত্র
e-mail	ই-মেইল
embrace	আলিঙ্গন
emerge	উত্থান
emergency	জরুরী
emission	নিঃসরণ
emotion	আবেগ
emotional	আবেগপ্রবণ
emphasis	জোর
emphasize	জোর দেওয়া
employ	নিয়োগ
employee	কর্মচারী
employer	নিয়োগকর্তা
employment	কর্মসংস্থান
empty	খালি
enable	সক্ষম করুন
encounter	সাক্ষাৎ
encourage	উৎসাহিত করা
end	শেষ
enemy	শত্রু
energy	শক্তি
enforcement	প্রয়োগ
engage	নিযুক্ত করা
engine	ইঞ্জিন
engineer	প্রকৌশলী
engineering	প্রকৌশল
English	ইংরেজি
enhance	উন্নত
enjoy	উপভোগ করুন
enormous	বিশাল
enough	যথেষ্ট
ensure	নিশ্চিত করা
enter	প্রবেশ করুন
enterprise	এন্টারপ্রাইজ
entertainment	বিনোদন
entire	সম্পূর্ণ
entirely	সম্পূর্ণরূপে
entrance	প্রবেশদ্বার
entry	প্রবেশ
environment	পরিবেশ
environmental	পরিবেশগত
episode	পর্ব
equal	সমান
equally	সমানভাবে
equate	সমান
equipment	সরঞ্জাম
era	যুগ
error	ত্রুটি
escape	পালানো
especially	বিশেষ করে
essay	রচনা
essential	অপরিহার্য
essentially	মূলত
establish	প্রতিষ্ঠা করা
establishment	প্রতিষ্ঠা
estate	সম্পত্তি
estimate	অনুমান
etc	ইত্যাদি
ethics	নৈতিকতা
ethnic	জাতিগত
European	ইউরোপীয়
evaluate	মূল্যায়ন
evaluation	মূল্যায়ন
even	এমন কি
evening	সন্ধ্যা
event	ঘটনা
eventually	অবশেষে
ever	কখনও
every	প্রতি
everybody	সবাই
everyday	প্রতিদিন
everyone	সবাই
everything	সবকিছু
everywhere	সর্বত্র
evidence	প্রমান
evolution	বিবর্তন
evolve	বিকশিত
exact	সঠিক
exactly	ঠিক
examination	পরীক্ষা
examine	পরীক্ষা করা
example	উদাহরণ
exceed	অতিক্রম
excellent	চমৎকার
except	ছাড়া
exception	ব্যতিক্রম
exchange	বিনিময়
excite	উত্তেজিত করা
exciting	উত্তেজনাপূর্ণ
executive	কার্যনির্বাহী
exercise	ব্যায়াম
exhibit	প্রদর্শনী
exhibition	প্রদর্শনী
exist	বিদ্যমান
existence	অস্তিত্ব
existing	বিদ্যমান
expand	বিস্তৃত করা
expansion	সম্প্রসারণ
expect	আশা করা
expectation	প্রত্যাশা
expense	ব্যয়
expensive	ব্যয়বহুল
experience	অভিজ্ঞতা
experiment	পরীক্ষা
expert	বিশেষজ্ঞ
explain	ব্যাখ্যা করা
explanation	ব্যাখ্যা
explode	বিস্ফোরিত
explore	অন্বেষণ
explosion	বিস্ফোরণ
expose	প্রকাশ করা
exposure	প্রকাশ
express	প্রকাশ করা
expression	অভিব্যক্তি
extend	প্রসারিত করা
extension	সম্প্রসারণ
extensive	ব্যাপক
extent	ব্যাপ্তি
external	বাহ্যিক
extra	অতিরিক্ত
extraordinary	অসাধারণ
extreme	চরম
extremely	অত্যন্ত
eye	চোখ
fabric	কাপড়
face	মুখ
facility	সুবিধা
fact	সত্য
factor	ফ্যাক্টর
factory	কারখানা
faculty	অনুষদ
fade	বিবর্ণ
fail	ব্যর্থ
failure	ব্যর্থতা
fair	ন্যায্য
fairly	ন্যায্যভাবে
faith	বিশ্বাস
fall	পতন
familiar	পরিচিত
family	পরিবার
famous	বিখ্যাত
fan	ভক্ত
fantasy	কল্পনা
far	দূরে
farm	খামার
farmer	কৃষক
fashion	ফ্যাশন
fast	দ্রুত
fat	চর্বি
fate	ভাগ্য
father	পিতা
fault	দোষ
favor	আনুকূল্য
favorite	প্রিয়
fear	ভয়
feature	বৈশিষ্ট্য
federal	ফেডারেল
fee	ফি
feed	খাওয়ান
feel	অনুভব করা
feeling	অনুভূতি
feet	পা দুটো
fell	পড়ে
fellow	সহকর্মী
felt	অনুভূত
female	মহিলা
fence	বেড়া
few	অল্প
fewer	কম
fiber	ফাইবার
fiction	কথাসাহিত্য
field	ক্ষেত্র
fifteen	পনের
fifth	পঞ্চম
fifty	পঞ্চাশ
fig	ডুমুর
fight	যুদ্ধ
fighter	যোদ্ধা
fighting	যুদ্ধ
figure	চিত্র
file	ফাইল
fill	পূরণ
film	চলচ্চিত্র
final	চূড়ান্ত
finally	অবশেষে
finance	অর্থায়ন
financial	আর্থিক
find	অনুসন্ধান
finding	খোঁজা
fine	ভাল
finger	আঙুল
finish	শেষ
fire	আগুন
firm	দৃঢ়
first	প্রথম
fish	মাছ
fishing	মাছ ধরা
fit	ফিট
fitness	ফিটনেস
five	পাঁচ
fix	ঠিক করা
flag	পতাকা
flame	শিখা
flat	সমান
flavor	স্বাদ
flee	ভাগা
flesh	মাংস
flight	ফ্লাইট
float	ভাসা
floor	মেঝে
flow	প্রবাহ
flower	ফুল
fly	উড়ে
focus	ফোকাস
folk	লোক
follow	অনুসরণ করুন
following	অনুসরণ
food	খাদ্য
foot	পা
football	ফুটবল
for	জন্য
force	বল
foreign	বিদেশী
forest	বন। জংগল
forever	চিরতরে
forget	ভুলে যাও
form	ফর্ম
formal	আনুষ্ঠানিক
formation	গঠন
former	সাবেক
formula	সূত্র
forth	সামনে
fortune	ভাগ্য
forward	এগিয়ে
found	পাওয়া
foundation	ভিত্তি
founder	প্রতিষ্ঠাতা
four	চার
fourth	চতুর্থ
fraction	ভগ্নাংশ
frame	ফ্রেম
framework	কাঠামো
free	বিনামূল্যে
freedom	স্বাধীনতা
freeze	বরফে পরিণত করা
French	ফরাসি
frequency	ফ্রিকোয়েন্সি
frequent	ঘন ঘন
frequently	ঘন ঘন
fresh	তাজা
friend	বন্ধু
friendly	বন্ধুত্বপূর্ণ
friendship	বন্ধুত্ব
from	থেকে
front	সামনে
fruit	ফল
frustration	পরাজয়
fuel	জ্বালানি
full	সম্পূর্ণ
fully	সম্পূর্ণরূপে
fun	মজা
function	ফাংশন
fund	তহবিল
fundamental	মৌলিক
funding	তহবিল
funeral	অন্ত্যেষ্টিক্রিয়া
funny	হাস্যকর
furniture	আসবাবপত্র
furthermore	উপরন্তু
future	ভবিষ্যৎ
gain	লাভ করা
galaxy	ছায়াপথ
gallery	গ্যালারি
game	খেলা
gang	দল
gap	ফাঁক
garage	গ্যারেজ
garden	বাগান
garlic	রসুন
gas	গ্যাস
gate	গেট
gather	জড়ো করা
gave	দিয়েছে
gay	সমকামী
gaze	দৃষ্টি
gear	গিয়ার
gender	লিঙ্গ
gene	জিন
general	সাধারণ
generally	সাধারণত
generate	উৎপন্ন
generation	প্রজন্ম
genetic	জেনেটিক
gentle	মৃদু
gentleman	ভদ্রলোক
gently	আলতো করে
German	জার্মান
gesture	অঙ্গভঙ্গি
get	পাওয়া
ghost	প্রেতাত্মা
giant	দৈত্য
gift	উপহার
gifted	প্রতিভাধর
girl	মেয়ে
girlfriend	বান্ধবী
give	দাও
given	দেওয়া
glad	খুশি
glance	এক পলক দেখা
glass	কাচ
global	বিশ্বব্যাপী
glove	গ্লাভস
go	যাওয়া
goal	লক্ষ্য
God	সৃষ্টিকর্তা
gold	স্বর্ণ
golden	সোনালী
golf	গল্ফ
gone	সর্বস্বান্ত
good	ভাল
got	পেয়েছি
govern	শাসন
government	সরকার
governor	গভর্নর
grab	দখল
grade	শ্রেণী
gradually	ধীরে ধীরে
graduate	স্নাতক
grain	শস্য
grand	বড়
grandfather	দাদা
grandmother	দাদী
grant	প্রদান
grass	ঘাস
grave	কবর
gray	ধূসর
great	মহান
greatest	সর্বশ্রেষ্ঠ
green	সবুজ
grew	বড় হয়েছি
grocery	মুদিখানা
ground	স্থল
group	গ্রুপ
grow	বৃদ্ধি
growing	ক্রমবর্ধমান
growth	বৃদ্ধি
guarantee	গ্যারান্টি
guard	প্রহরী
guess	অনুমান
guest	অতিথি
guide	গাইড
guideline	নির্দেশিকা
guilty	দোষী
gun	বন্দুক
guy	লোক
habit	অভ্যাস
habitat	বাসস্থান
had	ছিল
hair	চুল
half	অর্ধেক
hall	হল
hand	হাত
handful	থাবা
handle	হাতল
hang	ঝুলানো
happen	ঘটে
happy	সুখী
hard	কঠিন
hardly	খুব কমই
has	আছে
hat	টুপি
hate	ঘৃণা
have	আছে
he	তিনি
head	মাথা
headline	শিরোনাম
headquarters	সদর দপ্তর
health	স্বাস্থ্য
healthy	সুস্থ
hear	শুনতে
heard	শুনেছি
hearing	শ্রবণ
heart	হৃদয়
heat	তাপ
heaven	স্বর্গ
heavily	ভারীভাবে
heavy	ভারী
heel	গোড়ালি
height	উচ্চতা
held	অনুষ্ঠিত
helicopter	হেলিকপ্টার
hell	জাহান্নাম
hello	হ্যালো
help	সাহায্য
helpful	সহায়ক
her	তার
here	এখানে
heritage	উত্তরাধিকার
hero	নায়ক
herself	নিজে
hey	আরে
hi	ওহে
hide	লুকান
high	উচ্চ
highlight	লক্ষণীয় করা
highly	অত্যন্ত
highway	হাইওয়ে
hill	পাহাড়
him	তার
himself	নিজে
hip	নিতম্ব
hire	ভাড়া
his	তার
historian	ইতিহাসবিদ
historic	তিহাসিক
historical	তিহাসিক
history	ইতিহাস
hit	আঘাত
hold	রাখা
hole	গর্ত
holiday	ছুটি
holy	পবিত্র
home	বাড়ি
homeless	গৃহহীন
honest	সৎ
honey	মধু
honor	সম্মান
hope	আশা
horizon	দিগন্ত
horror	ভয়াবহতা
horse	ঘোড়া
hospital	হাসপাতাল
host	হোস্ট
hot	গরম
hotel	হোটেল
hour	ঘন্টা
house	গৃহ
household	পরিবার
housing	হাউজিং
how	কিভাবে
however	যাহোক
huge	বিশাল
human	মানুষ
humor	মেজাজ
hundred	শত
hungry	ক্ষুধার্ত
hunt	খোজা
hunter	শিকারী
hunting	শিকার
hurry	তাড়াতাড়ি
hurt	আঘাত
husband	স্বামী
hypothesis	অনুমান
I	আমি
ice	বরফ
idea	ধারণা
ideal	আদর্শ
identification	শনাক্তকরণ
identify	চিহ্নিত করা
identity	পরিচয়
ie	যেমন
if	যদি
ignore	উপেক্ষা
ill	অসুস্থ
illegal	অবৈধ
illness	অসুস্থতা
illustrate	চিত্রিত করা
image	ছবি
imagination	কল্পনা
imagine	কল্পনা
immediate	অবিলম্বে
immediately	অবিলম্বে
immigrant	অভিবাসী
immigration	অভিবাসন
impact	প্রভাব
implement	বাস্তবায়ন
implication	অন্তর্নিহিত
imply	বোঝানো
importance	গুরুত্ব
important	গুরুত্বপূর্ণ
impose	চাপিয়ে দেওয়া
impossible	অসম্ভব
impress	মুগ্ধ করা
impression	ছাপ
impressive	চিত্তাকর্ষক
improve	উন্নতি
improvement	উন্নতি
in	ভিতরে
incentive	প্রণোদনা
inch	ইঞ্চি
incident	ঘটনা
include	অন্তর্ভুক্ত
including	সহ
income	আয়
incorporate	নিগমবদ্ধ
increase	বৃদ্ধি
increased	বেড়েছে
increasing	ক্রমবর্ধমান
increasingly	ক্রমবর্ধমানভাবে
incredible	অবিশ্বাস্য
indeed	প্রকৃতপক্ষে
independence	স্বাধীনতা
independent	স্বাধীন
index	সূচক
Indian	ভারতীয়
indicate	নির্দেশ করে
indication	ইঙ্গিত
individual	স্বতন্ত্র
industrial	শিল্প
industry	শিল্প
infant	শিশু
infection	সংক্রমণ
inflation	মুদ্রাস্ফীতি
influence	প্রভাব
inform	অবহিত করা
information	তথ্য
ingredient	উপাদান
initial	প্রাথমিক
initially	প্রাথমিকভাবে
initiative	উদ্যোগ
injury	আঘাত
inner	অভ্যন্তরীণ
innocent	নির্দোষ
inquiry	অনুসন্ধান
insect	পোকা
inside	ভিতরে
insight	অন্তর্দৃষ্টি
insist	জোর
inspire	অনুপ্রাণিত
install	ইনস্টল
instance	দৃষ্টান্ত
instant	তাত্ক্ষণিক
instead	পরিবর্তে
institution	প্রতিষ্ঠান
institutional	প্রাতিষ্ঠানিক
instruction	নির্দেশ
instructor	প্রশিক্ষক
instrument	যন্ত্র
insurance	বীমা
intellectual	বুদ্ধিজীবী
intelligence	বুদ্ধি
intend	অভিপ্রায়
intense	তীব্র
intensity	তীব্রতা
intention	অভিপ্রায়
interaction	মিথষ্ক্রিয়া
interest	স্বার্থ
interested	আগ্রহী
interesting	মজাদার
internal	অভ্যন্তরীণ
international	আন্তর্জাতিক
Internet	ইন্টারনেট
interpret	ব্যাখ্যা করা
interpretation	ব্যাখ্যা
intervention	হস্তক্ষেপ
interview	সাক্ষাৎকার
into	মধ্যে
introduce	পরিচয় করান
introduction	ভূমিকা
invasion	আক্রমণ
invent	উদ্ভাবন
invest	বিনিয়োগ
investigate	তদন্ত
investigation	তদন্ত
investigator	তদন্তকারী
investment	বিনিয়োগ
investor	বিনিয়োগকারী
invite	আমন্ত্রণ
involve	জড়িত
involved	জড়িত
involvement	সম্পৃক্ততা
Iraqi	ইরাকি
Irish	আইরিশ
iron	লোহা
is	হয়
Islamic	ইসলামী
island	দ্বীপ
Israeli	ইসরায়েলি
issue	সমস্যা
it	এটা
Italian	ইতালিয়ান
item	আইটেম
its	এর
itself	নিজেই
jacket	জ্যাকেট
jail	জেল
Japanese	জাপানি
jet	জেট
Jew	ইহুদি
Jewish	ইহুদি
job	চাকরি
join	যোগদান
joint	যৌথ
joke	কৌতুক
journal	জার্নাল
journalist	সাংবাদিক
journey	যাত্রা
joy	আনন্দ
judge	বিচারক
judgment	বিচার
juice	রস
jump	লাফ
junior	জুনিয়র
jury	জুরি
just	শুধু
justice	বিচার
justify	ন্যায্যতা
keep	রাখা
kept	রাখা
key	চাবি
kick	লাথি
kid	বাচ্চা
kill	হত্যা
killer	হত্যাকারী
killing	হত্যা
kind	ধরনের
king	রাজা
kiss	চুম্বন
kitchen	রান্নাঘর
knee	হাঁটু
knew	জানতাম
knife	ছুরি
knock	ঠক্ঠক্
know	জানি
knowledge	জ্ঞান
lab	ল্যাব
label	লেবেল
labor	শ্রম
laboratory	পরীক্ষাগার
lack	অভাব
lady	ভদ্রমহিলা
lake	হ্রদ
land	জমি
landscape	প্রাকৃতিক দৃশ্য
language	ভাষা
lap	ভাঁজ
large	বড়
largely	মূলত
last	শেষ
late	দেরী
later	পরে
Latin	ল্যাটিন
latter	পরবর্তী
laugh	হাস
launch	শুরু করা
law	আইন
lawn	লন
lawsuit	মামলা
lawyer	আইনজীবী
lay	রাখা
layer	স্তর
lead	সীসা
leader	নেতা
leadership	নেতৃত্ব
leading	নেতৃস্থানীয়
leaf	পাতা
league	লীগ
lean	রোগা
learn	শিখুন
learning	শেখা
least	কমপক্ষে
leather	চামড়া
leave	ছেড়ে
led	এলইডি
left	বাম
leg	পা
legacy	উত্তরাধিকার
legal	আইনি
legend	কিংবদন্তি
legislation	আইন
legitimate	বৈধ
lemon	লেবু
length	দৈর্ঘ্য
less	কম
lesson	পাঠ
let	দিন
letter	চিঠি
level	স্তর
liberal	উদার
library	গ্রন্থাগার
license	লাইসেন্স
lie	মিথ্যা
life	জীবন
lifestyle	জীবনধারা
lifetime	আজীবন
lift	উত্তোলন
light	আলো
like	মত
likely	সম্ভবত
limit	সীমা
limitation	সীমাবদ্ধতা
limited	সীমিত
line	লাইন
link	লিঙ্ক
lip	ঠোঁট
liquid	তরল
list	তালিকা
listen	শোন
literally	আক্ষরিকভাবে
literary	সাহিত্যিক
literature	সাহিত্য
little	সামান্য
live	লাইভ দেখান
living	জীবিত
load	বোঝা
loan	দেনা
local	স্থানীয়
locate	সনাক্ত করা
location	অবস্থান
lock	তালা
log	লগ
lone	একা
long	দীর্ঘ
long-term	দীর্ঘ মেয়াদী
look	চেহারা
loose	আলগা
lose	হারান
loss	ক্ষতি
lost	নিখোঁজ
lot	অনেক
lots	প্রচুর
loud	জোরে
love	ভালবাসা
lovely	সুন্দর
lover	প্রেমিক
low	কম
lower	নিম্ন
luck	ভাগ্য
lucky	ভাগ্যবান
lunch	মধ্যাহ্নভোজ
lung	ফুসফুস
machine	মেশিন
mad	পাগল
made	তৈরি
magazine	পত্রিকা
magnet	চুম্বক
mail	মেইল
main	প্রধান
mainly	প্রধানত
maintain	বজায় রাখা
maintenance	রক্ষণাবেক্ষণ
major	প্রধান
majority	সংখ্যাগরিষ্ঠতা
make	তৈরি করা
maker	নির্মাতা
makeup	মেকআপ
male	পুরুষ
mall	মল
man	মানুষ
manage	পরিচালনা
management	ব্যবস্থাপনা
manager	ম্যানেজার
manner	পদ্ধতি
manufacturer	প্রস্তুতকারক
manufacturing	উত্পাদন
many	অনেক
map	মানচিত্র
margin	মার্জিন
mark	চিহ্ন
market	বাজার
marketing	বিপণন
marriage	বিবাহ
married	বিবাহিত
marry	বিবাহ করা
mask	মুখোশ
mass	ভর
massive	বিশাল
master	মাস্টার
match	ম্যাচ
material	উপাদান
math	গণিত
matter	ব্যাপার
may	পারে
maybe	হতে পারে
mayor	মেয়র
me	আমাকে
meal	খাবার
mean	মানে
meaning	অর্থ
meant	বোঝানো হয়েছে
meanwhile	ইতিমধ্যে
measure	পরিমাপ করা
measurement	মাপা
meat	মাংস
mechanism	পদ্ধতি
media	মিডিয়া
medical	চিকিৎসা
medication	ষধ
medicine	ঔষধ
medium	মধ্যম
meet	সম্মেলন
meeting	সভা
melody	সুর
member	সদস্য
membership	সদস্যপদ
memory	স্মৃতি
men	পুরুষ
mental	মানসিক
mention	উল্লেখ
menu	তালিকা
mere	নিছক
merely	নিছক
mess	জগাখিচুড়ি
message	বার্তা
metal	ধাতু
meter	মিটার
method	পদ্ধতি
Mexican	মেক্সিকান
middle	মাঝখানে
might	হতে পারে
mile	মাইল
military	সামরিক
milk	দুধ
million	মিলিয়ন
mind	মন
mine	আমার
minister	মন্ত্রী
minor	গৌণ
minority	নাবালকত্ব
minute	মিনিট
miracle	অলৌকিক ঘটনা
mirror	আয়না
miss	হারানো
missile	ক্ষেপণাস্ত্র
mission	মিশন
mistake	ভুল
mix	মিশ্রণ
mixture	মিশ্রণ
mm-hmm	মিমি-হুম
mode	মোড
model	মডেল
moderate	মধ্যপন্থী
modern	আধুনিক
modest	বিনয়ী
molecule	অণু
mom	মা
moment	মুহূর্ত
money	টাকা
monitor	মনিটর
month	মাস
mood	মেজাজ
moon	চাঁদ
moral	নৈতিক
more	আরো
moreover	উপরন্তু
morning	সকাল
mortgage	বন্ধক
most	সর্বাধিক
mostly	অধিকাংশ ক্ষেত্রে
mother	মা
motion	গতি
motivation	প্রেরণা
motor	মোটর
mount	মাউন্ট
mountain	পর্বত
mouse	ইঁদুর
mouth	মুখ
move	সরানো
movement	আন্দোলন
movie	সিনেমা
Mr	জনাব
Mrs	জনাবা
Ms	মাইক্রোসফট
much	অনেক
multiple	একাধিক
multiply	গুণ
murder	হত্যা
muscle	পেশী
museum	জাদুঘর
music	সঙ্গীত
musical	বাদ্যযন্ত্র
musician	সঙ্গীতশিল্পী
Muslim	মুসলিম
must	অবশ্যই
mutual	পারস্পরিক
my	আমার
myself	আমি
mystery	রহস্য
myth	শ্রুতি
naked	নগ্ন
name	নাম
narrative	বর্ণনামূলক
narrow	সংকীর্ণ
nation	জাতি
national	জাতীয়
native	স্থানীয়
natural	প্রাকৃতিক
naturally	স্বাভাবিকভাবে
nature	প্রকৃতি
near	কাছাকাছি
nearby	কাছাকাছি
nearly	প্রায়
necessarily	অগত্যা
necessary	প্রয়োজনীয়
neck	ঘাড়
need	প্রয়োজন
negative	নেতিবাচক
negotiate	আলোচনা
negotiation	আলাপ – আলোচনা
neighbor	প্রতিবেশী
neighborhood	পাড়া
neither	না
nerve	স্নায়ু
nervous	স্নায়বিক
net	জাল
network	অন্তর্জাল
never	কখনো না
nevertheless	তবুও
new	নতুন
newly	সদ্য
news	খবর
newspaper	সংবাদপত্র
next	পরবর্তী
nice	চমৎকার
night	রাত
nine	নয়
no	না
nobody	কেউ না
nod	সম্মতি
noise	গোলমাল
nomination	মনোনয়ন
none	কোন
nonetheless	তবুও
noon	দুপুর
nor	না
normal	স্বাভাবিক
normally	স্বাভাবিকভাবে
north	উত্তর
northern	উত্তর
nose	নাক
not	না
note	বিঃদ্রঃ
nothing	কিছুই না
notice	বিজ্ঞপ্তি
notion	ধারণা
noun	বিশেষ্য
novel	উপন্যাস
now	এখন
nowhere	কোথাও
n’t	না
nuclear	পারমাণবিক
number	সংখ্যা
numeral	সংখ্যা
numerous	অনেক
nurse	নার্স
nut	বাদাম
object	বস্তু
objective	উদ্দেশ্য
obligation	বাধ্যবাধকতা
observation	পর্যবেক্ষণ
observe	পর্যবেক্ষণ
observer	পর্যবেক্ষক
obtain	প্রাপ্ত
obvious	স্পষ্ট
obviously	স্পষ্টতই
occasion	উপলক্ষ
occasionally	মাঝে মাঝে
occupation	পেশা
occupy	দখল করা
occur	ঘটে
ocean	সমুদ্র
odd	অস্বাভাবিক
odds	মতভেদ
of	এর
off	বন্ধ
offense	অপরাধ
offensive	আক্রমণাত্মক
offer	অফার
office	দপ্তর
officer	অফিসার
official	দাপ্তরিক
often	প্রায়ই
oh	উহু
oil	তেল
ok	ঠিক আছে
okay	ঠিক আছে
old	পুরাতন
Olympic	অলিম্পিক
on	চালু
once	একদা
one	এক
ongoing	চলমান
onion	পেঁয়াজ
online	অনলাইন
only	কেবল
onto	উপর
open	খোলা
opening	খোলা
operate	কাজ
operating	অপারেটিং
operation	অপারেশন
operator	অপারেটর
opinion	মতামত
opponent	প্রতিপক্ষ
opportunity	সুযোগ
oppose	বিরোধিতা করা
opposite	বিপরীত
opposition	বিরোধী দল
option	বিকল্প
or	অথবা
orange	কমলা
order	আদেশ
ordinary	সাধারণ
organ	অঙ্গ
organic	জৈব
organization	সংগঠন
organize	সংগঠিত করা
orientation	অভিযোজন
origin	উৎপত্তি
original	মূল
originally	মূলত
other	অন্য
others	অন্যান্য
otherwise	অন্যথায়
ought	উচিত
our	আমাদের
ourselves	আমরা
out	বাইরে
outcome	ফলাফল
outside	বাইরে
oven	চুলা
over	উপর
overall	সামগ্রিকভাবে
overcome	পরাস্ত করা
overlook	উপেক্ষা
owe	পাওনা
own	নিজস্ব
owner	মালিক
oxygen	অক্সিজেন
pace	গতি
pack	প্যাক
package	প্যাকেজ
page	পৃষ্ঠা
pain	ব্যথা
painful	বেদনাদায়ক
paint	পেইন্ট
painter	চিত্রশিল্পী
painting	পেইন্টিং
pair	জোড়া
pale	ফ্যাকাশে
Palestinian	ফিলিস্তিনি
palm	তালু
pan	প্যান
panel	প্যানেল
pant	প্যান্ট
paper	কাগজ
paragraph	অনুচ্ছেদ
parent	পিতামাতা
park	পার্ক
parking	পার্কিং
part	অংশ
participant	অংশগ্রহণকারী
participate	অংশগ্রহণ
participation	অংশগ্রহণ
particular	বিশেষভাবে
particularly	বিশেষ করে
partly	আংশিকভাবে
partner	অংশীদার
partnership	অংশীদারিত্ব
party	পার্টি
pass	পাস
passage	উত্তরণ
passenger	যাত্রী
passion	আবেগ
past	অতীত
patch	প্যাচ
path	পথ
patient	রোগী
pattern	প্যাটার্ন
pause	বিরতি
pay	বেতন
payment	পেমেন্ট
PC	পিসি
peace	শান্তি
peak	শিখর
peer	সমকক্ষ ব্যক্তি
penalty	জরিমানা
people	মানুষ
pepper	মরিচ
per	প্রতি
perceive	অনুধাবন
percentage	শতাংশ
perception	উপলব্ধি
perfect	নিখুঁত
perfectly	নিখুঁতভাবে
perform	সঞ্চালন
performance	কর্মক্ষমতা
perhaps	সম্ভবত
period	সময়কাল
permanent	স্থায়ী
permission	অনুমতি
permit	অনুমতি
person	ব্যক্তি
personal	ব্যক্তিগত
personality	ব্যক্তিত্ব
personally	ব্যক্তিগতভাবে
personnel	কর্মীরা
perspective	দৃষ্টিকোণ
persuade	পটান
pet	পোষা প্রাণী
phase	পর্যায়
phenomenon	ঘটমান বিষয়
philosophy	দর্শন
phone	ফোন
photo	ছবি
photograph	আলোকচিত্র
photographer	ফটোগ্রাফার
phrase	বাক্যাংশ
physical	শারীরিক
physically	শারীরিকভাবে
physician	চিকিৎসক
piano	পিয়ানো
pick	বাছাই
picture	ছবি
pie	পাই
piece	টুকরা
pile	গাদা
pilot	বিমান – চালক
pine	পাইন
pink	গোলাপী
pipe	পাইপ
pitch	পিচ
place	স্থান
plain	সমতল
plan	পরিকল্পনা
plane	বিমান
planet	গ্রহ
planning	পরিকল্পনা
plant	উদ্ভিদ
plastic	প্লাস্টিক
plate	প্লেট
platform	প্ল্যাটফর্ম
play	খেলা
player	খেলোয়াড়
please	অনুগ্রহ
pleasure	আনন্দ
plenty	প্রচুর
plot	পটভূমি
plural	বহুবচন
plus	প্লাস
pocket	পকেট
poem	কবিতা
poet	কবি
poetry	কবিতা
point	বিন্দু
pole	মেরু
police	পুলিশ
policy	নীতি
political	রাজনৈতিক
politically	রাজনৈতিকভাবে
politician	রাজনীতিবিদ
politics	রাজনীতি
poll	ভোট
pollution	দূষণ
pool	পুল
poor	দরিদ্র
pop	পপ
popular	জনপ্রিয়
populate	জনসংখ্যা
population	জনসংখ্যা
porch	বারান্দা
port	বন্দর
portion	অংশ
portrait	প্রতিকৃতি
portray	ভাষায় বর্ণনা করা
pose	অঙ্গবিক্ষেপ
position	অবস্থান
positive	ইতিবাচক
possess	অধিকারী
possibility	সম্ভাবনা
possible	সম্ভব
possibly	সম্ভবত
post	পোস্ট
pot	পাত্র
potato	আলু
potential	সম্ভাব্য
potentially	সম্ভাব্য
pound	পাউন্ড
pour	জন্য
poverty	দারিদ্র্য
powder	পাউডার
power	ক্ষমতা
powerful	ক্ষমতাশালী
practical	ব্যবহারিক
practice	অনুশীলন করা
pray	প্রার্থনা
prayer	প্রার্থনা
precisely	অবিকল
predict	ভবিষ্যদ্বাণী করা
prefer	পছন্দ
preference	পছন্দ
pregnancy	গর্ভাবস্থা
pregnant	গর্ভবতী
preparation	প্রস্তুতি
prepare	প্রস্তুত করা
prescription	প্রেসক্রিপশন
presence	উপস্থিতি
present	বর্তমান
presentation	উপস্থাপনা
preserve	সংরক্ষণ করা
president	রাষ্ট্রপতি
presidential	রাষ্ট্রপতি
press	প্রেস
pressure	চাপ
pretend	ভান করা
pretty	সুন্দর
prevent	প্রতিরোধ
previous	আগে
previously	পূর্বে
price	মূল্য
pride	গর্ব
priest	পুরোহিত
primarily	প্রাথমিকভাবে
primary	প্রাথমিক
prime	প্রধান
principal	অধ্যক্ষ
principle	নীতি
print	ছাপা
prior	পূর্বে
priority	অগ্রাধিকার
prison	কারাগার
prisoner	বন্দী
privacy	গোপনীয়তা
private	ব্যক্তিগত
probable	সম্ভাব্য
probably	সম্ভবত
problem	সমস্যা
procedure	পদ্ধতি
proceed	এগিয়ে যান
process	প্রক্রিয়া
produce	উৎপাদন করা
producer	প্রযোজক
product	পণ্য
production	উৎপাদন
profession	পেশা
professional	পেশাদার
professor	অধ্যাপক
profile	প্রোফাইল
profit	লাভ
program	কার্যক্রম
progress	অগ্রগতি
project	প্রকল্প
prominent	বিশিষ্ট
promise	প্রতিজ্ঞা
promote	প্রচার করা
prompt	শীঘ্র
proof	প্রমাণ
proper	সঠিক
properly	সঠিকভাবে
property	সম্পত্তি
proportion	অনুপাত
proposal	প্রস্তাব
propose	প্রস্তাব
proposed	প্রস্তাবিত
prosecutor	প্রসিকিউটর
prospect	সম্ভাবনা
protect	রক্ষা করা
protection	সুরক্ষা
protein	প্রোটিন
protest	প্রতিবাদ
proud	গর্বিত
prove	প্রমাণ
provide	প্রদান
provider	প্রদানকারী
province	প্রদেশ
provision	বিধান
psychological	মানসিক
psychologist	মনোবিজ্ঞানী
psychology	মনোবিজ্ঞান
public	জনসাধারণ
publication	প্রকাশনা
publicly	প্রকাশ্যে
publish	প্রকাশ করা
publisher	প্রকাশক
pull	টান
punishment	শাস্তি
purchase	ক্রয়
pure	বিশুদ্ধ
purpose	উদ্দেশ্য
pursue	অন্বেষণ করা
push	ধাক্কা
put	লাগান
qualify	যোগ্যতা
quality	মান
quart	চতুর্থাংশ
quarter	চতুর্থাংশ
quarterback	কোয়ার্টারব্যাক
question	প্রশ্ন
quick	দ্রুত
quickly	দ্রুত
quiet	শান্ত
quietly	শান্তভাবে
quit	প্রস্থান
quite	বেশ
quote	উদ্ধৃতি
quotient	ভাগফল
race	জাতি
racial	জাতিগত
radical	মৌলবাদী
radio	রেডিও
rail	রেল
rain	বৃষ্টি
raise	উত্থাপন
ran	দৌড়ে
range	পরিসীমা
rank	পদমর্যাদা
rapid	দ্রুত
rapidly	দ্রুত
rare	বিরল
rarely	খুব কমই
rate	হার
rather	বরং
rating	রেটিং
ratio	অনুপাত
raw	কাঁচা
reach	পৌঁছানো
react	প্রতিক্রিয়া
reaction	প্রতিক্রিয়া
read	পড়ুন
reader	পাঠক
reading	পড়া
ready	প্রস্তুত
real	বাস্তব
reality	বাস্তবতা
realize	উপলব্ধি
really	সত্যিই
reason	কারণ
reasonable	যুক্তিসঙ্গত
recall	প্রত্যাহার
receive	গ্রহণ
recent	সাম্প্রতিক
recently	সম্প্রতি
recipe	রেসিপি
recognition	স্বীকৃতি
recognize	চিনতে
recommend	সুপারিশ
recommendation	সুপারিশ
record	রেকর্ড
recording	রেকর্ডিং
recover	পুনরুদ্ধার
recovery	পুনরুদ্ধার
recruit	নিয়োগ
red	লাল
reduce	কমানো
reduction	হ্রাস
refer	উল্লেখ করুন
reference	রেফারেন্স
reflect	প্রতিফলিত করা
reflection	প্রতিফলন
reform	সংশোধন
refugee	উদ্বাস্তু
refuse	প্রত্যাখ্যান
regard	সম্মান
regarding	সংক্রান্ত
regardless	নির্বিশেষে
regime	শাসন
region	অঞ্চল
regional	আঞ্চলিক
register	নিবন্ধন
regular	নিয়মিত
regularly	নিয়মিত
regulate	নিয়ন্ত্রণ করা
regulation	প্রবিধান
reinforce	শক্তিশালী করা
reject	প্রত্যাখ্যান
relate	বলা
relation	সম্পর্ক
relationship	সম্পর্ক
relative	আপেক্ষিক
relatively	অপেক্ষাকৃত
relax	শিথিল
release	মুক্তি
relevant	প্রাসঙ্গিক
relief	স্বস্তি
religion	ধর্ম
religious	ধর্মীয়
rely	নির্ভর করা
remain	থাকে
remaining	অবশিষ্ট
remarkable	অসাধারণ
remember	মনে রাখবেন
remind	মনে করিয়ে দেওয়া
remote	দূরবর্তী
remove	অপসারণ
repeat	পুনরাবৃত্তি
repeatedly	বারংবার
replace	প্রতিস্থাপন
reply	উত্তর
report	রিপোর্ট
reporter	প্রতিবেদক
represent	চিত্রিত করা
representation	উপস্থাপনা
representative	প্রতিনিধি
Republican	রিপাবলিকান
reputation	খ্যাতি
request	অনুরোধ
require	প্রয়োজন
requirement	প্রয়োজন
research	গবেষণা
researcher	গবেষক
resemble	অনুরূপ
reservation	রিজার্ভেশন
resident	বাসিন্দা
resist	প্রতিহত করা
resistance	প্রতিরোধ
resolution	রেজোলিউশন
resolve	সমাধান
resort	অবলম্বন
resource	সম্পদ
respect	সম্মান
respond	সাড়া দিন
respondent	উত্তরদাতা
response	প্রতিক্রিয়া
responsibility	দায়িত্ব
responsible	দায়ী
rest	বিশ্রাম
restaurant	রেঁস্তোরা
restore	পুনরুদ্ধার
restriction	নিষেধাজ্ঞা
result	ফলাফল
retain	ধরে রাখা
retire	অবসর
retirement	অবসর
return	প্রত্যাবর্তন
reveal	প্রকাশ করা
revenue	রাজস্ব
review	পুনঃমূল্যায়ন
revolution	বিপ্লব
rhythm	ছন্দ
rice	চাল
rich	ধনী
rid	পরিত্রাণ
ride	রাইড
rifle	রাইফেল
right	ঠিক
ring	রিং
rise	উত্থান
risk	ঝুঁকি
river	নদী
road	রাস্তা
rock	শিলা
role	ভূমিকা
roll	রোল
romantic	রোমান্টিক
roof	ছাদ
room	ঘর
root	মূল
rope	দড়ি
rose	গোলাপ
rough	রুক্ষ
roughly	মোটামুটি
round	গোল
route	রুট
routine	রুটিন
row	সারি
rub	ঘষা
rule	নিয়ম
run	দৌড়
running	চলমান
rural	গ্রামীণ
rush	ভিড়
Russian	রাশিয়ান
sacred	পবিত্র
sad	দু sadখজনক
safe	নিরাপদ
safety	নিরাপত্তা
said	বলেন
sail	পাল
sake	খাতিরে
salad	সালাদ
salary	বেতন
sale	বিক্রয়
sales	বিক্রয়
salt	লবণ
same	একই
sample	নমুনা
sanction	অনুমোদন
sand	বালি
sat	বসে
satellite	উপগ্রহ
satisfaction	সন্তোষ
satisfy	পরিতৃপ্ত করা
sauce	সস
save	সংরক্ষণ
saving	সঞ্চয়
saw	দেখেছি
say	বলুন
scale	স্কেল
scandal	কলঙ্ক
scared	ভীত
scenario	দৃশ্য
scene	দৃশ্য
schedule	সময়সূচী
scheme	পরিকল্পনা
scholar	পণ্ডিত
scholarship	বৃত্তি
school	বিদ্যালয়
science	বিজ্ঞান
scientific	বৈজ্ঞানিক
scientist	বিজ্ঞানী
scope	সুযোগ
score	স্কোর
scream	চিৎকার
screen	পর্দা
script	লিপি
sea	সমুদ্র
search	অনুসন্ধান
season	মৌসম
seat	আসন
second	দ্বিতীয়
secret	গোপন
secretary	সচিব
section	অধ্যায়
sector	সেক্টর
secure	নিরাপদ
security	নিরাপত্তা
see	দেখা
seed	বীজ
seek	খোঁজা
seem	মনে হয়
segment	বিভাগ
seize	জব্দ করা
select	নির্বাচন করুন
selection	নির্বাচন
self	স্ব
sell	বিক্রি
Senate	সিনেট
senator	সিনেটর
send	পাঠান
senior	ঊর্ধ্বতন
sense	অনুভূতি
sensitive	সংবেদনশীল
sent	পাঠানো হয়েছে
sentence	বাক্য
separate	আলাদা
sequence	ক্রম
series	সিরিজ
serious	গুরুতর
seriously	গুরুত্ব সহকারে
serve	পরিবেশন
service	সেবা
session	সেশন
set	সেট
setting	বিন্যাস
settle	নিষ্পত্তি
settlement	বন্দোবস্ত
seven	সাত
several	বেশ কয়েকটি
severe	গুরুতর
sex	লিঙ্গ
sexual	যৌন
shade	ছায়া
shadow	ছায়া
shake	ঝাঁকি
shall	করবে
shape	আকৃতি
share	ভাগ
sharp	ধারালো
she	সে
sheet	শীট
shelf	তাক
shell	শেল
shelter	আশ্রয়
shift	স্থানান্তর
shine	উজ্জ্বল
ship	জাহাজ
shirt	শার্ট
shit	বিষ্ঠা
shock	শক
shoe	জুতা
shoot	গুলি
shooting	শুটিং
shop	দোকান
shopping	কেনাকাটা
shore	কূল
short	সংক্ষিপ্ত
shortly	শীঘ্রই
shot	গুলি
should	উচিত
shoulder	কাঁধ
shout	চিৎকার
show	দেখান
shower	ঝরনা
shrug	কুঁচকানো
shut	বন্ধ
sick	অসুস্থ
side	পাশ
sigh	দীর্ঘশ্বাস
sight	দৃষ্টিশক্তি
sign	চিহ্ন
signal	সংকেত
significance	তাৎপর্য
significant	তাৎপর্যপূর্ণ
significantly	উল্লেখযোগ্যভাবে
silence	নীরবতা
silent	নীরব
silver	রূপা
similar	অনুরূপ
similarly	একইভাবে
simple	সহজ
simply	কেবল
sin	পাপ
since	থেকে
sing	গান
singer	গায়ক
single	অবিবাহিত
sink	ডুব
sir	স্যার
sister	বোন
sit	বসা
site	সাইট
situation	পরিস্থিতি
six	ছয়
size	আকার
ski	স্কি
skill	দক্ষতা
skin	চামড়া
sky	আকাশ
slave	ক্রীতদাস
sleep	ঘুম
slice	টুকরা
slide	স্লাইড
slight	সামান্য
slightly	সামান্য
slip	স্লিপ
slow	ধীর
slowly	ধীরে ধীরে
small	ছোট
smart	স্মার্ট
smell	গন্ধ
smile	হাসি
smoke	ধোঁয়া
smooth	মসৃণ
snap	স্ন্যাপ
snow	তুষার
so	তাই
so-called	তথাকথিত
soccer	ফুটবল
social	সামাজিক
society	সমাজ
soft	নরম
software	সফটওয়্যার
soil	মাটি
solar	সৌর
soldier	সৈনিক
solid	কঠিন
solution	সমাধান
solve	সমাধান
some	কিছু
somebody	কেউ
somehow	একরকম
someone	কেউ
something	কিছু
sometimes	কখনও কখনও
somewhat	কিছুটা
somewhere	কোথাও
son	পুত্র
song	গান
soon	শীঘ্রই
sophisticated	পরিশীলিত
sorry	দুখিত
sort	সাজান
soul	আত্মা
sound	শব্দ
soup	স্যুপ
source	সূত্র
south	দক্ষিণ
southern	দক্ষিণ
Soviet	সোভিয়েত
space	স্থান
Spanish	স্পেনীয়
speak	কথা বল
speaker	বক্তা
special	বিশেষ
specialist	বিশেষজ্ঞ
species	প্রজাতি
specific	নির্দিষ্ট
specifically	বিশেষভাবে
speech	বক্তৃতা
speed	গতি
spell	বানান
spend	ব্যয় করা
spending	খরচ
spin	স্পিন
spirit	আত্মা
spiritual	আধ্যাত্মিক
split	বিভক্ত
spoke	কথা বলেছেন
spokesman	মুখপাত্র
sport	খেলা
spot	স্পট
spread	ছড়িয়ে পড়া
spring	বসন্ত
square	বর্গক্ষেত্র
squeeze	চাপ
stability	স্থিতিশীলতা
stable	স্থিতিশীল
staff	কর্মী
stage	মঞ্চ
stair	সিঁড়ি
stake	অংশীদারিত্ব
stand	দাঁড়ানো
standard	মান
standing	দাঁড়িয়ে
star	তারা
stare	তাকান
start	শুরু
state	অবস্থা
statement	বিবৃতি
station	স্টেশন
statistics	পরিসংখ্যান
status	অবস্থা
stay	থাকা
stead	স্থির
steady	স্থির
steal	চুরি
steam	বাষ্প
steel	ইস্পাত
step	পদক্ষেপ
stick	লাঠি
still	এখনও
stir	আলোড়ন
stock	স্টক
stomach	পেট
stone	পাথর
stood	দাঁড়িয়ে
stop	থামুন
storage	স্টোরেজ
store	ভাণ্ডার
storm	ঝড়
story	গল্প
straight	সোজা
strange	অদ্ভুত
stranger	অপরিচিত
strategic	কৌশলগত
strategy	কৌশল
stream	প্রবাহ
street	রাস্তা
strength	শক্তি
strengthen	শক্তিশালী করা
stress	চাপ
stretch	প্রসারিত
strike	ধর্মঘট
string	স্ট্রিং
strip	ফালা
stroke	স্ট্রোক
strong	শক্তিশালী
strongly	দৃ়ভাবে
structure	গঠন
struggle	সংগ্রাম
student	ছাত্র
studio	স্টুডিও
study	অধ্যয়ন
stuff	জিনিসপত্র
stupid	বোকা
style	শৈলী
subject	বিষয়
submit	জমা দিন
subsequent	পরবর্তী
substance	পদার্থ
substantial	যথেষ্ট
subtract	বিয়োগ
succeed	সফল
success	সাফল্য
successful	সফল
successfully	সফলভাবে
such	যেমন
sudden	হঠাৎ
suddenly	হঠাৎ
sue	মামলা
suffer	ভোগা
sufficient	যথেষ্ট
suffix	প্রত্যয়
sugar	চিনি
suggest	পরামর্শ
suggestion	পরামর্শ
suicide	আত্মহত্যা
suit	স্যুট
summer	গ্রীষ্ম
summit	শীর্ষ
sun	সূর্য
super	সুপার
supply	সরবরাহ
support	সমর্থন
supporter	সমর্থক
suppose	ধরুন
supposed	অনুমিত
Supreme	সর্বোচ্চ
sure	নিশ্চিত
surely	অবশ্যই
surface	পৃষ্ঠতল
surgery	অস্ত্রোপচার
surprise	আশ্চর্য
surprised	অবাক
surprising	বিস্ময়কর
surprisingly	আশ্চর্যজনকভাবে
surround	চারপাশে
survey	জরিপ
survival	বেঁচে থাকা
survive	বেঁচে থাকা
survivor	বেঁচে থাকা
suspect	সন্দেহ
sustain	টিকিয়ে রাখা
swear	শপথ
sweep	পরিষ্কার করা
sweet	মিষ্টি
swim	সাঁতার কাটা
swing	দোল
switch	সুইচ
syllable	অক্ষর
symbol	প্রতীক
symptom	উপসর্গ
system	পদ্ধতি
table	টেবিল
tablespoon	টেবিল চামচ
tactic	কৌশল
tail	লেজ
take	গ্রহণ করা
tale	গল্প
talent	প্রতিভা
talk	আলাপ
tall	লম্বা
tank	ট্যাংক
tap	টোকা
tape	টেপ
target	লক্ষ্য
task	কাজ
taste	স্বাদ
tax	কর
taxpayer	করদাতা
tea	চা
teach	শেখান
teacher	শিক্ষক
teaching	শিক্ষা
team	টীম
tear	টিয়ার
teaspoon	চা চামচ
technical	প্রযুক্তিগত
technique	প্রযুক্তি
technology	প্রযুক্তি
teen	কিশোর
teenager	কিশোর
teeth	দাঁত
telephone	টেলিফোন
telescope	টেলিস্কোপ
television	টেলিভিশন
tell	বল
temperature	তাপমাত্রা
temporary	অস্থায়ী
ten	দশ
tend	প্রবণতা
tendency	প্রবণতা
tennis	টেনিস
tension	চিন্তা
tent	তাঁবু
term	মেয়াদ
terms	পদ
terrible	ভয়ানক
territory	এলাকা
terror	সন্ত্রাস
terrorism	সন্ত্রাস
terrorist	সন্ত্রাসী
test	পরীক্ষা
testify	সাক্ষ্য দেওয়া
testimony	সাক্ষ্য
testing	পরীক্ষামূলক
text	পাঠ্য
than	তুলনায়
thank	ধন্যবাদ
thanks	ধন্যবাদ
that	যে
the	দ্য
theater	থিয়েটার
their	তাদের
them	তাদের
theme	থিম
themselves	নিজেদের
then	তারপর
theory	তত্ত্ব
therapy	থেরাপি
there	সেখানে
therefore	অতএব
these	এইগুলো
they	তারা
thick	পুরু
thin	পাতলা
thing	জিনিস
think	ভাবুন
thinking	চিন্তা
third	তৃতীয়
thirty	ত্রিশ
this	এই
those	সেগুলো
though	যদিও
thought	চিন্তা
thousand	হাজার
threat	হুমকি
threaten	হুমকি দেওয়া
three	তিন
throat	গলা
through	মাধ্যম
throughout	জুড়ে
throw	নিক্ষেপ
thus	এইভাবে
ticket	টিকিট
tie	টাই
tight	টাইট
time	সময়
tiny	ক্ষুদ্র
tip	টিপ
tire	পাগড়ি
tired	ক্লান্ত
tissue	টিস্যু
title	শিরোনাম
to	প্রতি
tobacco	তামাক
today	আজ
toe	পায়ের আঙ্গুল
together	একসাথে
told	বলেছেন
tomato	টমেটো
tomorrow	আগামীকাল
tone	স্বর
tongue	জিহ্বা
tonight	আজ রাতে
too	খুব
took	নিয়েছে
tool	টুল
tooth	দাঁত
top	শীর্ষ
topic	বিষয়
toss	টস
total	মোট
totally	সম্পূর্ণভাবে
touch	স্পর্শ
tough	শক্ত
tour	সফর
tourist	পর্যটক
tournament	টুর্নামেন্ট
toward	দিকে
towards	দিকে
tower	টাওয়ার
town	শহর
toy	খেলনা
trace	ট্রেস
track	ট্র্যাক
trade	বাণিজ্য
tradition	তিহ্য
traditional	ঐতিহ্যবাহী
traffic	ট্রাফিক
tragedy	দুঃখজনক ঘটনা
trail	লেজ
train	ট্রেন
training	প্রশিক্ষণ
transfer	স্থানান্তর
transform	রূপান্তর
transformation	রূপান্তর
transition	স্থানান্তর
translate	অনুবাদ করা
transportation	পরিবহন
travel	ভ্রমণ
treat	চিকিত্সা
treatment	চিকিৎসা
treaty	চুক্তি
tree	গাছ
tremendous	অসাধারণ
trend	প্রবণতা
trial	বিচার
triangle	ত্রিভুজ
tribe	উপজাতি
trick	কৌশল
trip	ট্রিপ
troop	সৈন্য
trouble	ঝামেলা
truck	ট্রাক
truly	সত্যিই
trust	বিশ্বাস
truth	সত্য
try	চেষ্টা করুন
tube	নল
tunnel	টানেল
turn	পালা
TV	টেলিভিশন
twelve	বারো
twenty	বিশ
twice	দুবার
twin	যমজ
two	দুই
type	টাইপ
typical	সাধারণ
typically	সাধারণত
ugly	কুৎসিত
ultimate	চূড়ান্ত
ultimately	শেষ পর্যন্ত
unable	অক্ষম
uncle	চাচা
under	অধীনে
undergo	সহ্য করা
understand	বোঝা
understanding	বোঝার
unfortunately	দুর্ভাগ্যবশত
uniform	ইউনিফর্ম
union	মিলন
unique	অনন্য
unit	ইউনিট
United	ইউনাইটেড
universal	সর্বজনীন
universe	বিশ্বব্রহ্মাণ্ড
university	বিশ্ববিদ্যালয়
unknown	অজানা
unless	যদি না
unlike	ভিন্ন
unlikely	অসম্ভাব্য
until	পর্যন্ত
unusual	অস্বাভাবিক
up	উপরে
upon	উপর
upper	উপরের
urban	শহুরে
urge	তাড়ন
us	আমাদের
use	ব্যবহার
used	ব্যবহৃত
useful	দরকারী
user	ব্যবহারকারী
usual	চলিত
usually	সাধারণত
utility	উপযোগ
vacation	ছুটি
valley	উপত্যকা
valuable	মূল্যবান
value	মান
variable	পরিবর্তনশীল
variation	প্রকরণ
variety	বৈচিত্র্য
various	বিভিন্ন
vary	বিভিন্ন
vast	বিশাল
vegetable	শাকসবজি
vehicle	যানবাহন
venture	উদ্যোগ
verb	ক্রিয়া
version	সংস্করণ
versus	বনাম
very	খুব
vessel	পাত্র
veteran	অভিজ্ঞ
via	মাধ্যমে
victim	শিকার
victory	বিজয়
video	ভিডিও
view	দেখুন
viewer	দর্শক
village	গ্রাম
violate	লঙ্ঘন করা
violation	লঙ্ঘন
violence	সহিংসতা
violent	হিংস্র
virtually	কার্যত
virtue	পুণ্য
virus	ভাইরাস
visible	দৃশ্যমান
vision	দৃষ্টি
visit	পরিদর্শন
visitor	দর্শনার্থী
visual	চাক্ষুষ
vital	গুরুত্বপূর্ণ
voice	ভয়েস
volume	আয়তন
volunteer	স্বেচ্ছাসেবক
vote	ভোট
voter	ভোটার
vowel	স্বরবর্ণ
vs	বনাম
vulnerable	দুর্বল
wage	বেতন
wait	অপেক্ষা করুন
wake	জাগো
walk	হাঁটা
wall	প্রাচীর
wander	বিচরণ
want	চাই
war	যুদ্ধ
warm	উষ্ণ
warn	সতর্ক করা
warning	সতর্কতা
was	ছিল
wash	ধোয়া
waste	বর্জ্য
watch	ঘড়ি
water	জল
wave	তরঙ্গ
way	উপায়
we	আমরা
weak	দুর্বল
wealth	ধন
wealthy	ধনী
weapon	অস্ত্র
wear	পরিধান
weather	আবহাওয়া
wedding	বিবাহ
week	সপ্তাহ
weekend	সপ্তাহান্তে
weekly	সাপ্তাহিক
weigh	ওজন
weight	ওজন
welcome	স্বাগত
welfare	কল্যাণ
well	আমরা হব
went	গিয়েছিলাম
were	ছিল
west	পশ্চিম
western	পশ্চিমা
wet	ভেজা
what	কি
whatever	যাই হোক
wheel	চাকা
when	কখন
whenever	যখনই
where	কোথায়
whereas	যেখানে
whether	কিনা
which	যা
while	যখন
whisper	ফিসফিস
white	সাদা
who	কে
whole	পুরো
whom	যাকে
whose	যার
why	কেন
wide	প্রশস্ত
widely	ব্যাপকভাবে
widespread	ব্যাপক
wife	স্ত্রী
wild	বন্য
will	ইচ্ছাশক্তি
willing	রাজী
win	জয়
wind	বায়ু
window	জানলা
wine	মদ
wing	ডানা
winner	বিজয়ী
winter	শীত
wipe	মুছা
wire	তার
wisdom	প্রজ্ঞা
wise	জ্ঞানী
wish	ইচ্ছা
with	সঙ্গে
withdraw	প্রত্যাহার
within	মধ্যে
without	ছাড়া
witness	সাক্ষী
woman	নারী
women	নারী
won’t	করবে না
wonder	আশ্চর্য
wonderful	চমৎকার
wood	কাঠ
wooden	কাঠের
word	শব্দ
work	কাজ
worker	কর্মী
working	কাজ
works	কাজ করে
workshop	কর্মশালা
world	পৃথিবী
worried	উদ্বিগ্ন
worry	দুশ্চিন্তা
worth	মূল্য
would	হবে
wound	ক্ষত
wrap	মোড়ানো
write	লিখুন
writer	লেখক
writing	লেখা
written	লিখিত
wrong	ভুল
wrote	লিখেছেন
yard	আঙ্গিনা
yeah	হ্যাঁ
year	বছর
yell	চিৎকার
yellow	হলুদ
yes	হ্যাঁ
yesterday	গতকাল
yet	এখনো
yield	ফলন
you	আপনি
young	তরুণ
your	তোমার
yours	তোমার
yourself	নিজেকে
youth	যৌবন
zombie	জম্বি
zone	মণ্ডল
zoo	চিড়িয়াখানা
zoology	প্রাণীবিদ্যা
zoom	জুম
I  আমি
a  একটি
able  সক্ষম
about  সম্পর্কে
above  উপরে
act  আইন
add  যোগ  করা
after  পরে
afternoon  অপরাহ্ন
again  আবার
against  বিরুদ্ধে
age  বয়স
agree  একমত
air  বায়ু
all  সব
allow  অনুমতি
also  এছাড়াও
always  সবসময়
and  এবং
anger  রাগ
animal  পশু
answer  উত্তর
any  কোনো
appear  প্রদর্শিত
apple  আপেল
are  হয়
area  ক্ষেত্র
arrange  ব্যবস্থা
arrive  পৌঁছা
art  শিল্প
ask  জিজ্ঞাসা
at  এ
atom  পরমাণু
baby  শিশুর
back  ফিরে
bad  খারাপ
band  ব্যান্ড
bank  ব্যাংক
bar  বার
base  ঘাঁটি
basic  মৌলিক
bat  বাদুড়
be  হতে
bear  ভালুক
beat  বীট
beauty  সৌন্দর্য
bed  বিছানা
been  হয়েছে
before  আগে
behind  পিছনে
believe  বিশ্বাস
bell  ঘণ্টা
best  সেরা
bird  পাখি
bit  কিছুক্ষণ
black  কালো
block  ব্লক
blood  রক্ত
blow  ঘা
blue  নীল
board  বোর্ড
boat  নৌকা
body  শরীর
bone  হাড়
book  বই
born  জন্ম
both  উভয়
bottom  নীচে
bought  কেনা
box  বক্স
boy  ছেলে
branch  শাখা
bread  রুটি
break  বিরতি
bright  উজ্জ্বল
bring  আনা
broad  বিস্তৃত
broke  ভেঙে
brother  ভাই
brought  উপনীত
brown  বাদামী
build  নির্মাণ
burn  বার্ন
busy  ব্যস্ত
but  কিন্তু
buy  কিনতে
by  দ্বারা
call  কল
came  আসেন
camp  শিবির
can  করতে পারেন
capital  রাজধানী
captain  অধিনায়ক
car  গাড়ী
card  কার্ড
care  যত্ন
carry  বহন
case  কেস
cat  বিড়াল
catch  ধরা
cause  কারণ
cell  সেল
cent  শতাংশ
center  কেন্দ্র
century  শতাব্দীর
certain  নির্দিষ্ট
chair  চেয়ার
chance  সুযোগ
change  পরিবর্তন
character  চরিত্র
charge  চার্জ
chart  চার্ট
check  চেক
chick  কুক্কুট
children  শিশু
choose  নির্বাচন
chord  জ্যা
circle  বৃত্ত
city  শহর
claim  দাবি
class  বর্গ
clean  পরিষ্কার
clear  স্পষ্ট
climb  আরোহনের
clothe  আবৃত  করা	
cloud  মেঘ
coast  উপকূল
coat  কোট
cold  ঠান্ডা
collect  সংগ্রহ  করা
colony  উপনিবেশ
color  রঙ
column  কলাম
come  আসা
company  কোম্পানি
compare  তুলনা
complete  সম্পূর্ণ
condition  শর্ত
connect  সংযোগ
consider  বিবেচনা  করা
consonant  ব্যঞ্জনবর্ণ
contain  ধারণ
continent  মহাদেশ
continue  অবিরত
control  নিয়ন্ত্রণ
cook  রান্নাঘর
copy  কপি
corn  ভূট্টা
corner  কোণ
correct  সঠিক
cost  খরচ
cotton  তুলা
could  পারা
count  গণনা
country  দেশ
course  মাঠ
cover  কভার
cow  গাভী
crease  ভাঁজ  করা
crop  ফসল
cross  ক্রুশ
crowd  ভিড়
cry  কান্নাকাটি
cut  কাটা
dance  নাচ
danger  বিপদ
dark  অন্ধকার
day  দিন
dead  মৃত
deal  লেনদেন
dear  দুর্মূল্য
death  মৃত্যুর
decide  স্থির  করা
decimal  দশমিক
deep  গভীর
degree  ডিগ্রী
depend  নির্ভর  করে	
describe  বর্ণনা
desert  মরুভূমি
design  নকশা
determine  নির্ধারণ
develop  বিকাশ
dictionary  অভিধান
die  মরা
differ  পৃথক
direct  সরাসরি
discuss  আলোচনা
distant  দূরবর্তী
division  বিভাগ
doctor  ডাক্তার
does  না
dog  কুকুর
dollar  ডলার
door  দরজা
double  ডবল
down  নিচে
draw  আঁকা
dream  স্বপ্ন
dress  পোশাক
drink  পানীয়
drive  ড্রাইভ
drop  ঝরা
dry  শুষ্ক
duck  হাঁস
each  প্রতিটি
ear  কান
earth  পৃথিবী
ease  আরাম
east  পূর্ব
eat  খাওয়া
edge  প্রান্ত
effect  প্রভাব
egg  ডিম
eight  আট
electric  বৈদ্যুতিক
else  অন্য
end  শেষ
enemy  শত্রু
energy  শক্তি
engine  ইঞ্জিন
enough  যথেষ্ট
enter  প্রবেশ
equal  সমান
equate  সমীকরণ
even  এমনকি
evening  সন্ধ্যায়
event  ঘটনা
ever  কখনও
every  প্রতি
example  উদাহরণ
except  ছাড়া
excite  জাগান
exercise  ব্যায়াম
experience  অভিজ্ঞতা
eye  চোখ
face  মুখ
fact  আসলে
fair  ন্যায্য
family  পরিবার
famous  বিখ্যাত
far  পর্যন্ত
farm  খামার
fat  চর্বি
father  বাবা
favor  আনুকূল্য
fear  ভয়
feed  ফিড
feet  ফুট
fell  হিংস্র
felt  অনুভূত
few  কয়েক
fig  ডুমুর
figure  ব্যক্তিত্ব
fill  পূরণ
final  চূড়ান্ত
find  এটি
fine  জরিমানা
finger  আঙুল
fire  আগুন
first  প্রথম
fish  মাছ
fit  মাপসই
five  পাঁচ
flat  ফ্ল্যাট
floor  মেঝে
flow  প্রবাহ
flower  ফুল
fly  উড়ে
follow  অনুসরণ
food  খাদ্য
foot  পা
for  জন্য
force  বল
forest  বন
form  ফর্ম
forward  অগ্রবর্তী
four  চার
fraction  ভগ্নাংশ
free  বিনামূল্যে
fresh  তাজা
friend  বন্ধু
from  থেকে
front  সামনে
fruit  ফল
full  পূর্ণ
garden  বাগান
gas  গ্যাস
gather  জড়ো  করা
gave  দিয়েছেন
gentle  মৃদু
get  পাওয়া
girl  মেয়ে
give  দিতে
glad  আনন্দিত
glass  কাচ
go  যাওয়া
gold  স্বর্ণ
gone  সর্বস্বান্ত
got  পেয়েছিলাম
grand  গ্র্যান্ড
grass  ঘাস
gray  ধূসর
great  মহান
green  সবুজ
ground  স্থল
group  গ্রুপ
grow  হত্তয়া
guess  অনুমান
guide  কৌশল
gun  বন্দুক
hair  চুল
half  অর্ধ
hand  হাত
happen  ঘটা
happy  খুশি
hard  কঠিন
hat  টুপি
have  আছে
he  তিনি
head  মাথা
hear  শ্রবণ
heard  শোনা
heart  হৃদয়
heat  তাপ
heavy  ভারী
held  অনুষ্ঠিত
help  সাহায্য
here  এখানে
high  উচ্চ
hill  পাহাড়
him  তাকে
his  তার
history  ইতিহাস
hit  আঘাত
hole  গর্ত
home  হোম
hope  আশা
horse  ঘোড়া
hot  গরম
hour  ঘন্টা
house  ঘর
how  কিভাবে
huge  বিশাল
human  মানবীয়
hundred  শত
hunt  খোঁজা
hurry  ত্বরা
ice  বরফ
idea  ধারণা
if  যদি
imagine  কল্পনা
in  মধ্যে
inch  ইঞ্চি
include  অন্তর্ভুক্ত
indicate  নির্দেশ
insect  পোকা
instant  তাত্ক্ষণিক
instrument  উপকরণ
interest  সুদ
invent  উদ্ভাবিত
iron  লোহা
island  দ্বীপ
it  এটা
join  যোগদান
joy  আনন্দ
jump  ঝাঁপ
just  ঠিক
keep  রাখা
key  চাবি
kill  হত্যা
kind  ধরনের
king  রাজা
knew  জানতাম
know  জানা
lady  ভদ্রমহিলা
lake  হ্রদ
land  জমি
language  ভাষা
large  বড়
late  দেরী
laugh  মজা
lead  নেতৃত্ব
learn  শেখা
least  অন্তত
leave  ত্যাগ
led  চালিত
left  বাকি
length  দৈর্ঘ্য
let  যাক
letter  চিঠি
level  স্তর
lie  মিথ্যা
life  জীবন
lift  লিফট
light  আলো
like  মত
line  লাইন
liquid  তরল
list  তালিকা
listen  শুনতে
little  সামান্য
live  বাস
locate  সনাক্ত
log  লগ  ইন
lone  নির্জন
long  দীর্ঘ
look  চেহারা
lost  হারিয়ে
loud  অট্ট
love  প্রেম
low  কম
machine  মেশিন
made  তৈরি
magnet  চুম্বক
main  প্রধান
man  মানুষ
map  মানচিত্র
mark  চিহ্ন
market  বাজার
mass  ভর
master  মাস্টার
match  ম্যাচ
material  উপাদান
matter  ব্যাপার
me  আমাকে
mean  গড়
meant  বোঝানো
measure  পরিমাপ
meat  মাংস
melody  সুর
men  পুরুষ
metal  ধাতু
method  পদ্ধতি
middle  মধ্যম
mile  মাইল
milk  দুধ
million  মিলিয়ন
mind  মন
mine  খনি
minute  মিনিট
miss  মিস্
mix  মিশ্রিত  করা
modern  আধুনিক
molecule  ক্ষুদ্র অণু 
moment  মুহূর্ত
money  টাকা
month  মাস
moon  চাঁদ
more  আরো
morning  সকাল
most  সবচেয়ে
mother  মা
mount  মাউন্ট
mountain  পর্বত
move  পদক্ষেপ
much  অনেক
multiply  সংখ্যাবৃদ্ধি
music  সঙ্গীত
must  অবশ্যই
my  আমার
name  নাম
natural  প্রাকৃতিক
nature  প্রকৃতি
near  কাছাকাছি
necessary  প্রয়োজনীয়
neck  ঘাড়
need  প্রয়োজন
neighbor  প্রতিবেশী
new  নতুন
next  পরবর্তী
night  রাত
nine  নয়
no  কোন
noon  দুপুর
nose  নাক
note  নোট
nothing  কিছুই
notice  বিজ্ঞপ্তি
noun  বিশেষ্য
now  এখন
number  সংখ্যা
object  বস্তু
observe  পালন করা
occur  ঘটতে
ocean  মহাসাগর
of  এর
off  বন্ধ
offer  প্রস্তাব
office  অফিস
often  প্রায়ই
oh  উহু
oil  তেল
old  পুরাতন
on  উপর
once  একবার
one  এক
only  শুধুমাত্র
open  খোলা
opposite  বিপরীত
or  বা
order  যাতে
organ  অঙ্গ
original  মূল
other  অন্যান্য
out  আউট
own  নিজস্ব
oxygen  অক্সিজেন
page  পৃষ্ঠা
pair  জোড়া
paper  কাগজ
paragraph  অনুচ্ছেদ
parent  পিতা বা মাতা	
part  অংশ
pass  পাস
past  গত
path  পথ
pattern  প্যাটার্ন
pay  পরিশোধ
perhaps  সম্ভবত
period  সময়ের
person  ব্যক্তি
phrase  ফ্রেজ
pick  বাছাই
picture  ছবি
piece  টুকরা
pitch  পিচ
place  স্থান
plain  সাধারণ
plan  পরিকল্পনা
plane  সমতল
planet  গ্রহ
plant  উদ্ভিদ
play  খেলা
please  করুন
plural  বহুবচন
poem  কবিতা
point  বিন্দু
poor  দরিদ্র
port  পোর্ট
pose  জাহির করা
position  অবস্থান
possible  সম্ভব
post  পোস্ট
pound  আধা  কেজি
power  ক্ষমতা
practice  অনুশীলন
present  বর্তমান
press  প্রেস
pretty  চমত্কার
print  মুদ্রণ
probable  সম্ভাব্য
problem  সমস্যা
process  প্রক্রিয়া
produce  উত্পাদন
product  পণ্য
property  সম্পত্তি
protect  রক্ষা
prove  প্রমাণ
provide  প্রদান
pull  টান
push  ধাক্কা
put  করা
question  প্রশ্ন
quick  দ্রুত
quiet  শান্ত
quite  পুরোপুরি
quotient  ভাগফল
race  জাতি
radio  রেডিও
rail  রেল
rain  বৃষ্টি
raise  বাড়াতে
ran  বিশেষত্বহীন
range  পরিসর
rather  বরং
reach  নাগাল
read  পড়া
ready  প্রস্তুত
real  বাস্তব
receive  পাবেন
record  রেকর্ড
red  লাল
region  অঞ্চল
repeat  পুনরাবৃত্তি
represent  প্রতিনিধিত্ব
result  ফলে
rich  সমৃদ্ধ
ride  যাত্রায়
right  অধিকার
ring  রিং
rise  ওঠা
river  নদী
road  রাস্তা
rock  শিলা
roll  রোল
room  রুম
root  রুট
rope  দড়ি
rose  গোলাপ
round  বৃত্তাকার
row  সারি
rub  বিপত্তি
rule  নিয়ম
run  রান
safe  নিরাপদ
said  বলেন
salt  লবণ
same  একই
sand  বালি
sat  শনি
save  সংরক্ষণ
saw  করাত
say  বলে
scale  স্কেল
school  স্কুল
science  বিজ্ঞান
score  স্কোর
sea  সমুদ্র
search  অনুসন্ধান
season  ঋতু
seat  আসন
second  দ্বিতীয়
section  অধ্যায়
see  দেখা
seed  বীজ
self  স্ব
sell  বিক্রি
send  পাঠান
sense  জ্ঞান
sent  পাঠানো
sentence  বাক্য
set  সেট
seven  সাত
several  বিভিন্ন
shall  হইবে
shape  আকৃতি
share  ভাগ
sharp  ধারালো
sheet  শীট
ship  জাহাজ
shoe  জুতো
shore  তীরে
short  সংক্ষিপ্ত
should  উচিত
shoulder  কাঁধ
shout  চিত্কার
show  শো
side  পাশ
sight  দৃষ্টিশক্তি
sign  সাইন
silent  নীরব
silver  রূপালী
similar  অনুরূপ
simple  সহজ
since  খবর
sing  গাত্তয়া
single  একক
sister  বোন
sit  বসতে
six  ছয়
size  আকার
skill  দক্ষতা
skin  ত্বক
sky  আকাশ
slave  ক্রীতদাস
sleep  ঘুম
slip  স্লিপ
slow  ধীর
small  ছোট
smell  গন্ধ
smile  হাসি
snow  তুষার
so  সুতরাং
soft  নরম
soil  মাটি
soldier  সৈনিক
solve  সমাধান
some  কিছু
song  গান
soon  শীঘ্রই
south  দক্ষিণ
special  বিশেষ
speech  বক্তৃতা
speed  গতি
spell  বানান
spend  ব্যয়
spoke  বক্তব্য  রাখেন
spot  অকুস্থল
spread  বিস্তার
spring  বসন্ত
stand  দাঁড়ানো
start  শুরু
state  রাষ্ট্র
station  স্টেশন
stay  থাকার
stead  উপকার
steam  বাষ্প
steel  ইস্পাত
stick  লাঠি
still  এখনও
stone  পাথর
stood  দাঁড়িয়ে
store  দোকান
story  গল্প
straight  সোজা
strange  অদ্ভুত
street  রাস্তায়
stretch  প্রসারিত
string  স্ট্রিং
strong  শক্তিশালী
student  ছাত্র
study  গবেষণা
substance  পদার্থ
subtract  বিয়োগ  করা
success  সাফল্য
such  এমন
sudden  আকস্মিক
sugar  চিনি
suggest  সুপারিশ
suit  মামলা
summer  গ্রীষ্ম
sun  সূর্য
supply  সরবরাহ
support  সমর্থন
sure  নিশ্চিত
surface  পৃষ্ঠ
surprise  বিস্ময়
swim  সাঁতার  কাটা
syllable  শব্দাংশ
symbol  প্রতীক
system  সিস্টেম
table  টেবিল
tail  লেঙ্গুড়
take  গ্রহণ  করা	
talk  আলাপ
tall  লম্বা
teach  শেখান
team  দল
teeth  দাঁত
tell  বলুন
temperature  তাপমাত্রা
ten  দশ
test  পরীক্ষা
than  তুলনায়
thank  ধন্যবাদ
that  যে
the  দী
their  তাদের
then  তারপর
there  সেখানে
they  তারা
thick  পুরু
thin  পাতলা
thing  বিষয়
think  মনে
third  তৃতীয়
this  এই
though  যদিও
thought  চিন্তার
thousand  হাজার
three  তিন
through  মাধ্যমে
throw  নিক্ষেপ
thus  এইভাবে
tie  টাই
time  সময়
tiny  অতি
tire  টায়রা
together  একসঙ্গে
told  বলা
tone  স্বন
tool  টুল
top  শীর্ষ
total  মোট
touch  স্পর্শ
toward  দিকে
town  শহরে
track  ট্র্যাক
trade  বাণিজ্য
train  ট্রেন
travel  ভ্রমণ
tree  গাছ
triangle  ত্রিভুজ
trip  ট্রিপ
trouble  কষ্ট
truck  ট্রাক
true  সত্য
try  চেষ্টা
tube  টিউব
turn  পালা
twenty  বিশ
two  দুই
type  টাইপ
under  অধীন
unit  ইউনিট
up  আপ
us  আমাদের
use  ব্যবহার
usual  স্বাভাবিক
valley  উপত্যকা
value  মূল্য
verb  ক্রিয়া
very  খুব
view  দেখুন
village  গ্রাম
visit  দর্শন
voice  ভয়েস
vowel  স্বরবর্ণ
wait  অপেক্ষা
wall  প্রাচীর
want  চান
war  যুদ্ধ
warm  উষ্ণ
was  ছিল
wash  ধোয়ার
watch  ঘড়ি
water  জল
wave  তরঙ্গ
way  উপায়
we  আমরা
wear  পরিধান
weather  আবহাওয়া
week  সপ্তাহে
weight  ওজন
well  ভাল
went  গিয়েছিলাম
west  পশ্চিম
what  কি
wheel  চাকা
when  যখন
where  যেখানে
whether  কিনা
which  যা
white  সাদা
who  যারা
whole  সমগ্র
whose  যার
why  কেন
wide  ব্যাপক
wife  স্ত্রী
wild  বন্য
will  অভিলাষ
win  জয়
window  উইন্ডো
wing  গরূৎ
winter  শীতকালীন
wire  তারের
wish  ইচ্ছুক
with  সঙ্গে
woman  নারী
wonder  আশ্চর্যের
wood  কাঠ
word  শব্দ
work  কাজ
world  বিশ্বের
would  হবে
write  লিখুন
written  লেখা
wrong  ভুল
wrote  লিখেছেন
yard  গজ
year  বছর
yellow  হলুদ
yes  হ্যাঁ
yet  এখনো
you  আপনি
young  তরুণ
your  আপনার
a  এক
a  ইংরেজী বর্ণমালার আদ্যাক্ষর
a  ইংরেজি বর্ণমালার প্রথম অক্ষর
aback  বিস্মিত
abandon  ত্যাগ করা
abandon  ত্যাগ করা
abandoned  পরিত্যক্ত
abandonment  বর্জন
abashed  হতভম্ব
abate  প্রকোপ হ্রাস করা
abatement  কম করা
abbey  মঠ
abbot  মঠের কর্তা
abbreviation  সংক্ষেপ করণ
abbreviations  শব্দসংক্ষেপ
abdicate  অধিকার ত্যাগ করা
abduction  অপহরণ
abed  শয্যাগত
aberrant  বিপদগামী
aberration  আপাত বিচ্যুতি
abeyance  মুলতবি
abhor  ঘৃণাভরে পরিহার করা
abide  মেনে চলা
abiding  মানিয়া চলে এমন
abilities  সামর্থ
ability  ক্ষমতা
abject  হীন
abjection  নীচ বা হীন অবস্থা
abjectly  শোচনীয়ভাবে
ablaze  জ্বলন্ত
ablaze  জ্বলন্ত
able  সক্ষম
ably  যোগ্যতার সহিত
abnormal  অস্বাভাবিক
abnormality  নিয়মের ব্যতিক্রম
abnormally  অস্বাভাবিকভাবে
aboard  জাহাজের মধ্যে
abode  বসবাস করা
abolish  বাতিল
abolition  বিলোপ
abominable  জঘন্য
abomination  জঘন্য
aboriginal  আদিবাসী
aborigines  আদিম অধিবাসীগণ
abort  অস্বাভাবিক সমাপ্তি
aborted  বাতিলকৃত
aborting  বাতিল করা হচ্ছে
abortion  গর্ভপাত
abound  সংখ্যায় যথেষ্ট
about  পরিচিতি
about  সংক্রান্ত
about  প্রায়
about  সম্বন্ধে
above  উপরে
above  উপরে
abrasive  ঘষে ফেলা যায় এমন
abreast  পাশাপাশি
abroad  বিদেশ
abrogate  আইন করা
abrupt  আকস্মিক
abscess  ফোড়া
abscissa  ভুজ
absence  অনুপস্থিত
absent  অনুপস্থিত
absentee  অনুপস্থিত লোক
absenteeism  নিজ গৃহ হতে প্রায় বাহিরে থাকার স্বভাব
absentmindedly  অন্যমনস্কভাবে
absolute  পরম
absolute  চরম
absolutely  বিনা শর্তে
absolution  দন্ড হতে অব্যহতি
absolutism  স্বৈরতন্ত্র শাসকের শাসন
absolve  অপারাধ হতে মুক্ত বলে ঘোষনা করা
absorb  আত্মভূত করা
absorbed  বিশোষিত
absorbent  শুষে নিতে পারে এমন
absorbing  অত্যান্ত চিত্তাকর্ষক
absorption  শোষণ
absorptive  শোষণক্ষম
abstain  বিরত থাকা
abstention  নিবৃত্ত
abstract  বিমূর্ত
abstracted  অন্যমনস্ক
abstraction  অন্যমনস্কতা
abstruse  দুর্বোধ্য
absurd  অসংগত
absurdity  অসংগতি
abundance  যথেষ্ট
abundant  অধিক
abuse  অপব্যবহার
abuse  গাল পাড়া
abuses  অপব্যবহার
abusive  নিন্দাময়
abysmal  অতল স্পর্শ
abyss  অতল গহ্বর
acacia  বাবলা জাতীয় গাছ
academic  শিক্ষায়তনিক
academician  অ্যাকাডেমির সদস্য
academy  একাডেমি
accede  রাজী হওয়া
accelerate  দ্রুততর করা
acceleration  ত্বরণ
accelerator  গতিবর্ধক
accelerators  গতিবর্ধক
accent  ধ্বনির তীব্রতা
accept  গ্রহণ করা
acceptable  গ্রহনযোগ্য
acceptance  গ্রহণযোগ্যতা
accepted  গ্রহণযোগ্য
accepted  গৃহিত
accepted  গৃহীত
access  উপলব্ধি করা
access  প্রবেশাধিকার
accessed  ব্যবহৃত
accessible  উপলভ্য
accessory  আনুষঙ্গিক
accessory  আনুষঙ্গিক
accident  দূর্ঘটনা
accidental  আকস্মিক
accidental.war  আকস্মিক যুদ্ধ
accidentally  দুর্ঘটনাবশত
acclaim  প্রশংসা
acclamation  হর্ষধ্বনি
accommodate  সমন্বয়বিধান করা
accommodating  মানিয়া নিতে পারে এমন
accommodation  বাসস্থান
accompany  সহগমন করা
accompanying  অনুযাত্রিক
accomplice  দুষ্কমের সহচর
accomplish  সুসম্পন্ন করা
accomplished  গুণান্বিত
accomplishment  সম্পাদন
accord  অনুযায়ী হওয়া
accord  অনুযায়ী হওয়া
according  অনুযায়ী
accordingly  তদনুসারে
accordion  বাদ্যযন্ত্র বিশেষ
account  অ্যাকাউন্ট
account  গণনা করা
accountability  জবাবদিহিতা
accountable  কৈফিয়ত দেওয়ার জন্য বাধ্য
accountant  হিসাবরক্ষক
accounting  হিসাবরক্ষণ
accounts  অ্যাকাউন্ট
accretion  বাহির হইতে যুক্ত হইয়া বৃদ্ধি
accrue  অর্জন
accumulate  জড়ো করা
accumulated  সমষ্টিকৃত
accumulation  সঞ্চয়
accumulator  সঞ্চয়কারী
accuracy  নির্ভুলতা
accurate  নির্ভূল
accurately  সঠিকভাবে
accusation  অভিযোগ
accuse  অভিযোগ করা
accused  অভিযুক্ত
accused  অভিযুক্ত
ache  বেদনা
ache  ব্যাথা করা
achieve  অর্জন
achievement  অর্জন
achievements  অর্জনসমূহ
acid  অম্ল
acidity  অম্লতা
acknowledge  প্রাপ্তিস্বীকার করা
acknowledgement  স্বীকার
acknowledgment  কৃতজ্ঞতাস্বীকার
acne  মুখব্রণ
acoustic  অ্যাকুসটিক
acoustics  স্বনবিদ্যা
acquaint  পরিচিত করানো
acquiescence  মৌনসম্মতি
acquire  অর্জন করা
acquire  অর্জন করা
acquisition  অর্জন
acquisitive  অর্জন করিতে ইচ্ছুক
acquit  বেকসুর খালাস দেওয়া
acquittal  আদালতের বিচারে খালাস
acre  একর
acreage  কোন এক খন্ড জমিতে একরের সংখ্যা
acrid  তিক্ত
acrimonious  উগ্র
acrobat  অ্যাক্রোব্যাট
acrobatic  মল্লক্রীড়া সম্বন্ধীয়
act  অভিনয় করা
act  অভিনয় করা
acting  কার্যবাহী
acting  অভিনয়
acting  কার্য সম্পাদান
action  কাজ
actionable  মোকদ্দমার যোগ্য
actions  ক্রিয়া
activate  সক্রিয়
activate  সক্রিয়করণ
activated  সক্রিয়
activation  সক্রিয়করণ
active  সক্রিয়
actively  সক্রিয়ভাবে
activist  সক্রিয় অংশগ্রহণকারী ব্যক্তি
activities  ক্রিয়াকলাপ
activity  ক্রিয়াকর্ম
actor  অভিনেতা
actress  অভিনেত্রী
actual  প্রকৃত
actually  প্রকৃতপক্ষে
actuary  বিমা সম্বন্ধীয় দক্ষ ব্যক্তি
actuate  কার্যে প্রবিত্ত করা
acumen  তীক্ষ্ণ বিচারশক্তি
acute  তীব্র
ad.agency  বিজ্ঞাপণী সংস্থা
adage  প্রবাদবাক্য
adamant  অত্যন্ত কঠিন বস্তু
adapt  পরিবর্তনের দ্বারা উপযোগী করা
adaptability  অভিযোজন ক্ষমতা
adaptable  পরিবর্তন যোগ্য
adaptation  অভিযোজন
add  যোগ
add  সংযুক্তকরণ
added  যোগ করা হয়েছে
addict  নেশাগ্রস্ত
addicted  আসক্ত
addictive  নেশা ধরানো
addition  সংযোজন
additional  অতিরিক্ত
additionally  অতিরিক্তভাবে
additions  সংযোজন
address  ঠিকানা
address  সম্বোধন করা
addressed  উদ্দেশ্যে বলা
addressee  প্রাপক
addresses  ঠিকানা
adduce  উদ্বুদ্ধ করা
adept  সুদক্ষ ব্যক্তি
adequacy  প্রাচুর্য
adequate  যথেষ্ট
adhere  অনুগত থাকা
adherence  অনুগত্য
adherent  অনুগত
adhesive  আঠা
adieu  বিদায়
adjacent  সংলগ্ন
adjective  বিশেষণ
adjournment  মুলতবি
adjudicate  রায় দেওয়া
adjudication  বিচারকের রায়
adjudicator  বিচারক
adjunct  বিশেষণ
adjust  সমন্বয়সাধন
adjustable  সমন্বয়যোগ্য
adjusted  সমন্বয়কৃত
adjustment  সমন্বয়সাধন
adjustments  সমন্বয়
administer  পরিচালনা
administration  প্রশাসন
administrative  প্রশাসনিক
administrator  অ্যাডমিনস্ট্রেটর
administrators  পরিচালক
admirable  প্রশংসনীয়
admiral  নৌ-সেনাপতি
admiralty  নৌ-বিভাগ
admiration  শ্রদ্ধা
admire  তারিফ করা
admirer  গুনমুদ্ধ ব্যক্তি
admissible  গ্রহনীয়
admission  প্রবেশাধিকার
admit  স্বীকার করা
admittance  প্রবেশ
admitted  স্বীকৃত
admittedly  সর্বম্মতিক্রমে
ado  গোলমাল
adobe  অ্যাডোব
adolescence  কৈশোর
adopt  অবলম্বন করা
adoptive  দত্তক গ্রহিতা
adorable  অতি আদরণীয়
adore  পুজা করা
adorn  সাজানো
adrenal  মুত্র গ্রন্থি সম্বন্ধীয়
adrift  ভাসমান অবস্থায়
adroit  নিপুন
adulation  চাটুবাদ
adult  প্রাপ্তবয়স্ক
adulterate  অপমিশ্রণ করা
adulterous  ব্যভিচারী
adultery  ব্যভিচার
advance  অগ্রসর
advance  অগ্রসর হওয়া
advance  অগ্রসর হওয়া
advanced  উন্নত
advanced  অগ্রসর
advancement  উন্নয়ন
advantage  সুবিধা
advantages  সুবিধা
advent  আগমন
adventitious  আকস্মিক
adventure  দুঃসাহসিকতা
adventurer  অভিযাত্রী
adventurous  দুঃসাহসিক
adverb  ক্রিয়া বিশেষণ
adverbial  ক্রিয়া বিশেষণ সম্বন্ধনীয়
adversary  বিপক্ষ
adverse  প্রতিকূল
adversity  প্রতিকূল অবস্থা
advert  মনফিরানো
advertise  প্রচার করা
advertisement  বিজ্ঞাপন
advertiser  বিজ্ঞাপন দাতা
advice  উপদেশ
advisable  যুক্তি সংগত
advise  পরামর্শ
advise  পরামর্শ দেওয়া
adviser  পরামর্শদাতা
advisory  উপদেষ্টা
advisor  পরামর্শক
advocacy  পক্ষাবলম্বন
advocate  উকিল
advocate  ওকালতি করা
aegis  তত্ত্বাবধান
aeon  যুগ
aerate  বাতাস প্রবেশ করানো
aerial  উচ্চ
aesthetic  সৌন্দর্য বিজ্ঞান বিষয়ক
aesthetics  সৌন্দর্য বিজ্ঞান
afar  বহুদুরে
affable  অমায়িক
affair  ঘটনা
affairs  ব্যাপার
affect  প্রভাবিত করা
affect  প্রভাবিত করা
affectation  ভন্ডামি
affected  প্রভাবিত
affected  প্রভাবিত
affects  প্রভাব
affiliate  শাখারূপে অন্তর্ভুক্ত হওয়া
affiliate  শাখারূপে অন্তর্ভুক্ত হওয়া
affiliated  অধিভুক্ত
affiliation  আসক্তি
affinity  অনুরাগ
affirmation  দৃঢ়োক্তি
affirmative  স্বীকৃতি সূচক
afflict  পীড়া দেয়া, কষ্ট দেয়া
afflicted  পীড়িত
affliction  মানসিক ক্লেষ
affluence  প্রাচুর্য
afford  সমর্থ হওয়া
affront  প্রকাশ্যে অপমান করা
aforementioned  পূর্বকথিত
aforethought  পূর্বকল্পিত
afraid  ভীত
aft  পশ্চাদ্বর্তী
after  পরে
after  পরে
afternoon  অপরাহ্ন
afterwards  পরে
again  পুনরায়
against  বিরুদ্ধে
age  বয়স
aged  বয়স্ক
agency  সংস্থা
agenda  সভায় আলচ্য বিষয় সূচি
agent  এজেন্ট
agents  দালাল
agglomerate  পিন্ড করা
agglomeration  পিন্ডীভূত হওয়া
aggregate  মোট
aggregation  পুঞ্জীকরণ
aggressive  উগ্র
aggressiveness  আগ্রাসনতা
aggressor  আক্রমণকারী দেশ
agility  তৎপরতা
agitation  আন্দোলন
agitator  উত্তেজনা সৃষ্টিকারী
agnomen  অতিরিক্ত নাম
ago  আগে
ago  আগে
agonizing  অত্যন্ত দুঃখ জনক
agony  নিদারুণ যন্ত্রণা
agrarian  কার্ষ
agrarian  কৃষি
agree  সম্মত হওয়া
agree  সম্মত হওয়া
agreement  মতৈক্য
agricultural  কৃষিবিষয়ক
agriculture  কৃষি
ah  আহা
ahead  আগে
aid  সাহায্য
aide  সহকারী
ailing  পীড়িত
ailment  ব্যাধি
aim  লক্ষ্য
aim  লক্ষ্য করা
air  বায়ু
airborne  বায়ুবাহিত
aircraft  বায়ুযান
airing  খোলা বাতাসে বেড়ানো
airline  যাত্রিবাহি বিমান চলাচল
airliner  বিমান
airport  বিমানবন্দর
airway  যে পথে নিয়মিত বিমান চলাচল করে
airy  বায়ুর মতো
aisle  অলিন্দ
akin  সদৃশ
al  আল
alarm  বিপদসংকেত
alarm  সংকেত
alarming  উদ্বেগ জনক
alarmingly  সাংঘাতিকভাবে
alas  হায়-হায়
albatross  সামুদ্রিক পক্ষি বিশেষ
album  অ্যালবাম
albums  অ্যালবাম
alchemy  কিমিয়া
alcohol  অ্যালকোহল
alert  সতর্ক
alert  সতর্ক
alert  সতর্ক করা
alert  সাবধান করা
alfresco  মুক্ত বায়ুতে
algebra  বীজগণিত
algorithm  অ্যালগোরিদম
alias  ওরফে
alibi  অজুহাত
alien  বিদেশী লোক
align  সারি দিয়ে সাজান
alignment  অ্যালাইনমেন্ট
alike  একই রকম
alike  সমরূপ
alive  জীবন্ত
alkali  ক্ষার
all  সব
all  সমস্ত
all  সমস্ত
allege  অভিযোগ করা
alleged  অভিযোগে বর্ণিত
alleged  অভিযোগে বর্ণিত
allegiance  আনুগত্ত
allegoric  রূপকাত্মক
allegorical  রূপকাত্মক
allegory  রূপক
allergy  রোগ বিশেষ
alleviate  লাঘব করা
alleviation  উদ্যানে বেড়াইবার পথ
allied  সন্ধিবদ্ধ
allies  সংযোগ
alliteration  অনুপ্রাস
allocate  বরাদ্দ করা
allocated  বরাদ্দকৃত
allocation  বরাদ্দ করা
allot  বন্টন করা
allotment  আবন্টন
allow  অনুমতি দেয়া
allow  অনুমোদন করা
allowance  ভাতা
allowed  অনুমোদিত
allows  অনুমোদন করে
alloy  সঙ্কর
alluring  লোভনীয়
allusions  পরোক্ষ উল্লেখ
ally  মৈত্রীবদ্ধ ব্যক্তি
almanac  পঞ্জিকা
almond  বাদাম
almost  প্রায়
aloft  ঊর্ধে
alone  একা
alone  একা
aloneness  একাকীত্ব
along  ধরে
alongside  পাশাপাশি
aloof  কিয়দ্দুরে
aloud  উচ্চ শব্দ করে
alpha  আলফা
alphabet  বর্ণমালা
alphabetic  বর্ণানুক্রম
alphabetically  বর্ণানুক্রমিক
already  ইতিমধ্যে
also  ও
altar  বেদী
alter  পরিবর্তন
alter  পরিবর্তন করা
alteration  বদল
altercation  বাদানুবাদ
alternate  বিকল্প
alternately  একান্তরভাবে
alternating  গতিবিমুখ
alternation  পর্যায়ক্রম
alternative  বিকল্প
alternative  বৈকল্পিক
alternatively  বৈকল্পিকভাবে
although  যদিও
altitude  উচ্চতা
altogether  একবারে
alum  ফট্‌কিরি
alumnus  প্রাক্তন ছাত্র
always  সবসময়
am  পূর্বাহ্ণ
am  হই
amalgam  পারদ মিশ্রিত ধাতু
amalgamate  মেশানো
amalgamation  মিশ্রণ
amanuensis  শ্রুতিলিপিকর
amass  সঞ্চয় করা
amassing  পুঞ্জীভূত করা
amateur  অপেশাদার
amaze  হতবুদ্ধি করা
amazed  আশ্চর্য হওয়া
amazement  আশ্চর্য
amazing  আশ্চর্যকর
ambassador  দূত
amber  তৈলস্ফটিক
ambiance  পরিবেশ
ambiguity  দ্ব্যর্থকতা
ambiguous  দ্ব্যর্থক
ambition  উচ্চাকাঙ্খা
ambitious  উচ্চাভিলাষী
amble  কদমে চলা
ambulance  অ্যাম্বুলেন্স
ambush  ওতপাতা
amelioration  উনতি
amen  তাই হোক
amenable  শাসনযোগ্য
amendment  সংশোধন
amongst  মধ্যে
amoral  অনৈতিক
amount  পরিমাণ
amount  পরিমাণ
amplify  বিবর্ধন
amplitude  বিস্তার
amusement  আমোদ-প্রমোদ
amusing  মজাদার
an  এক
an  একটি
anaerobic  অবাত
analogous  অনুরূপ
analyse  বিশ্লেষণ
analyse  বিশ্লেষণ করা
analyze  বিশ্লেষণ
analyze  বিশ্লেষণ করা
analyst  বিশ্লেষক
analyzer  বিশ্লেষক
anarchy  নৈরাজ্য
anatomy  শরীরতত্ত্ব
ancestor  পূর্বসূরী
anchor  নোঙ্গর
anchor  নোঙর করা
ancient  প্রাচীন
and  এবং
anemia  রক্তাল্পতা
angel  দেবদূত
anger  রাগ
angle  কোণ
angles  কোণ
angry  ক্রুদ্ধ
animal  প্রাণী
animal  পশু
animate  প্রাণসঞ্চার
animated  অ্যানিমেটেড
animation  অ্যানিমেশন
anise  মৌরিগাছ
annex  যোগ করা
annexation  সংযুক্তি
announce  ঘোষণা করা
announcement  ঘোষণা
announcing  ঘোষনা করা হচ্ছে
annoy  বিরক্ত করা
annoying  বিরক্তিকর
annual  বার্ষিক
annually  বছরে
annuity  বার্ষিক ভিত্তিতে নির্দিষ্ট অন্কের অর্থ
annum  বছর
anomaly  ব্যত্যয়
anonymous  অজ্ঞাতনামা
another  অন্য একটি
answer  উত্তর
answer  উত্তর দেওয়া
answers  উত্তর
ant  পিঁপড়ে
anthem  সংগীত
anthropology  নৃবিজ্ঞান
antibiotic  জীবাণু প্রতিরোধী
anticipate  আশা করা
anticipatory  প্রত্যাশামূলক
anticoagulant  তঞ্চন‌প্রতিরোধী
antidote  প্রতিশেধক
antiquated  মান্ধাত্যার আমলের
antique  প্রাচীন
antiquity  প্রাচীন নিদর্শন
antiviral  ভাইরাস প্রতিরোধী
anxious  উদগ্রীব
any  যেকোন
anybody  যে কেউ
anymore  আরো
anyone  যে কেউ
anything  যেকিছু
anytime  যে কোনো সময়
anyway  যেকোন উপায়ে
anywhere  যেখানে ইচ্ছা
aparently  আপাতভাবে
apart  পৃথকভাবে
apartheid  বর্ণ-বৈষম্য
apartment  কক্ষ
apathy  অনীহা
ape  বন মানুষ
aperture  পরিসর
apex  চূড়া
apogee  অপভূ
apology  ক্ষমা
apostle  ধর্ম প্রচারক
apothecary  ঔষধ ও চিকিৎসা সামগ্রী বিক্রেতা
apparatus  যন্ত্রপাতি
apparent  আপাত
appeal  আবেদন
appeal  আবেদন করা
appear  দেখা যাওয়া
appear  মনে হওয়া
appearance  চেহারা
append  সংযোজন
appetite  ক্ষুধা
apples  আপেলগুলি
appliance  সরঞ্জাম
applicable  প্রযোজ্য
application  অ্যাপলিকেশন
applications  অ্যাপলিকেশন
applied  ফলিত
apply  প্রয়োগ
appoint  নিযুক্ত করা
appreciate  মূল্যায়ন করা
approach  প্রবেশ
approach  অগ্রসর হওয়া
appropriate  উপযুক্ত
appropriately  সঠিকভাবে
approval  অনুমোদন
approve  অনুমোদন  করা
approved  অনুমোদিত
approvingly  সমর্থিত ভাবে
approximate  আন্দাজ
approximate  মোটামুটি
approximately  মোটামুটি ভাবে
approximately  আন্দাজ
apt  এপিটি
aquatic  জলজ
arabic  আরবী
arbitrary  খামখেয়ালী
arch  বক্ররেখা
archaeological  প্রত্নতাত্ত্বিক
architect  স্থপতী
architecture  স্থাপত্য
archive  আর্কাইভ
archives  আর্কাইভ
area  অংশ
areas  এলাকা
argriculture  কৃষি
argue  যুক্তি দেখানো
argument  প্রেরিত মান
aristocracy  অভিজাততন্ত্র
aristocrat  অভিজাত ব্যক্তি
aristocratic  আভিজাত্যপূর্ণ
arithmetic  পাটিগণিত
arm  বাহু
armed  সশস্ত্র
armor  ঢাল
armored  বর্ম-আচ্ছাদিত
armpit  বগল
around  চারপাশ
arrange  স্থির করা
arrangement  সুসজ্জায়ন
array  সারি
arrest  গ্রেপ্তার করা
arrest  গ্রেপ্তার করা
arrival  আগমন
arrive  উপস্থিত হওয়া
arrogance  অহংকার
arrow  তীর
arroyo  আরোইও
art  শিল্প
arterial  ধমনী সংক্রান্ত
artery  ধমনী
article  প্রবন্ধ
articles  নিবন্ধ
artifice  দক্ষতা
artificial  কৃত্রিম
artist  শিল্পী
artistic  শিল্পসম্মত
artistically  শৈল্পিকভাবে
artists  শিল্পী
arts  আর্টস
artwork  আর্টওয়ার্ক
as  যত
asbestos  অ্যাস্বেস্টস
asceticism  কঠোর তপস্যা
ascribe  আরোপ করা
aseptic  অপচনশীল
ash  ছাই
ask  জিজ্ঞাসা করা
asleep  ঘুমন্ত
aspect  দৃষ্টিভঙ্গি
aspects  বিভিন্ন দিক
aspiration  উচ্চাকাঙ্খা
ass  গাধা
assassinate  গুপ্তহত্যা করা
assassination  গুপ্তহত্যা
assembly  বিধানসভা
assert  জাহির
assess  নির্ধারণ করা
assessment  নির্ধারণ
asset  বিষয়সম্পত্তি
assign  বরাদ্দ করা
assigned  বরাদ্দকৃত
assignment  নির্দেশিত কাজ
assist  সহায়তা করা
assist  সহায়তা করা
assistance  সহায়তা
assistant  সহকারী
assistant  সহকারী
associate  সংশ্লিষ্ট
associate  সহযোগ করা
associated  সহযোগী
associated  সংশ্লিষ্ট
association  সমিতি
associations  সমিতি
assume  ধরে নেওয়া
assuming  ধরে নিয়ে
assumption  অনুমান
astrology  ফলিত জ্যোতিষ
astronaut  মহাশূন্যচারী
astronomy  জোতির্বিদ্যা
astrophysics  জ্যোতিঃপদার্থবিদ্যা
asymptotic  অসীমতট
atheist  নাস্তিক
atmosphere  বায়ুমণ্ডল
atomic  পারমাণবিক
atoms  পরমাণু
atonal  বেসুরো
atrocity  নৃশংসতা
attach  যুক্ত করা
attachment  সংযুক্তি
attack  আক্রমণ
attack  আক্রমণ করা
attacker  আক্রমণকারী
attacking  আক্রমণাত্মক
attacks  আক্রমণ
attaining  উপনীত হওয়া
attempt  প্রচেষ্টা
attempt  পেতে চেষ্টা করা
attempted  চেষ্টাকৃত
attempting  চেষ্টা করছি
attempts  প্রচেষ্টা
attend  উপস্থিত হওয়া
attendance  হাজিরা
attendant  খাদিম
attitude  মনোভাব
attorney  উকিল
attract  আকর্ষণ করা
attraction  আকর্ষণ
attractive  আকর্ষণীয়
attribute  বৈশিষ্ট্য
attribute  আরোপ করা
attributes  বৈশিষ্ট্যাবলী
au  এ-ইউ
auction  নিলাম করা
audience  দর্শক
audiences  দর্শক-শ্রোতা
audio  অডিও
audio  শব্দ
audit  হিসাব পরীক্ষণ
august  অগাস্ট
auspicious  মঙ্গলজনক
austerity  সন্ন্যাস
authentication  পরিচয় প্রমাণ প্রক্রিয়া
authenticity  সত্যতা
author  লেখক
authority  কর্তৃপক্ষ
authorization  প্রাপ্তাধিকার
authorize  অনুমোদন  করা
authorized  অনুমোদিত
authors  লেখক
auto  স্বয়ংক্রিয়
autobiographical  আত্মজীবনীমূলক
autobiography  আত্নজীবনী
autocracy  স্বৈরাচার
automate  স্বয়ংচল কর
automatic  স্বয়ংক্রিয়
automatically  সয়ংক্রিয়ভাবে
automobile  মোটরগাড়ি
automobiles  মোটরগাড়ি
automotive  যন্ত্রচালিত
autonomous  স্বশাসিত
autonomy  স্বশাসন
autopsy  শবদেহ পরীক্ষা
autumn  শরত্‍কাল
auxiliary  সাহায্যকারী
availability  সুবিধা
avalanche  হিমবাহ
average  গড়পড়তা
average  গড়
aversion  অনীহা
aviation  বিমান চলাচল
avidly  লুব্ধভাবে
avoid  এড়িয়ে চলা
avoid  এড়িয়ে চলা
avoidance  এড়ানো
await  অপেক্ষা করা
awake  জাগা
awake  জাগ্রত হওয়া
awaken  জাগ্রত করা
award  পূরস্কার
award  প্রদান করা
aware  সচেতন
away  দূরে
awkward  বেঢপ
axiom  প্রতিপাদ্য
babble  আধো আধো বোল
baboon  বেবুন
baby  শিশু
bachelor  স্নাতক
back  পিছন
back  পিছনে
back  পিছনে
back  সমর্থন করা
back.pain  পশ্চাতে ব্যাথা
backbone  মেরুদন্ড
background  পটভূমি
background  পশ্চাদপট
backing  সমর্থন
backup  ব্যাকআপ
backups  ব্যাকআপ
backward  পশ্চাত্‍
backwards  পিছনে
backyard  উঠোন
bacterium  ব্যাকটেরিয়া
bad  খারাপ
bad  ত্রুটিপূর্ণ
badge  ব্যাজ
badly  খারাপভাবে
baffling  হতাশজনক
bag  থলি
bags  থলি
bail  জামিন
bait  টোপ ফেলা
bakery  বেকারী
balance  ভারসাম্য
balance  ভারসাম্য রক্ষা করা
balcony  ঝোলা-বারান্দা
bald  টাক
bamboo  বাঁশ
ban  নিষেধ
ban  নিষিদ্ধ করা
ban  নিষিদ্ধ করা
banana  কলা
bananas  কলাগুলি
band  ব্যান্ড
bandit  ডাকাত
bandwidth  ব্যান্ডউইড্থ
bank  তীর
banker  মহাজন
banking  ব্যাঙ্কিং
banner  ব্যানার
banners  ব্যানার
bar  বাঁধা দেয়া
bar  নিষিদ্ধ করা
barbaric  বর্বরোচিত
barber  নাপিত
bard  চারণ
bare  খোলা
bargain  দরদাম করা
bargain  দরদাম করা
bark  ছাল
bark  চিৎকার করা
barley  যব
barometer  ব্যারোমিটার
barrier  বিভাজিকা
base  ভিত্তি
base  ভিত্তি করা
baseball  বেইসবল
based  ভিত্তি করে
basic  মৌলিক
basic  প্রাথমিক
basically  প্রাথমিকভাবে
basil  তুলসি
basin  গামলা
basis  ভিত্তি
bass  গলার নীচু খাদের সুর
bastard  অবৈধ সন্তান
bastion  বুরুজ
batch  ব্যাচ
bath  স্নান
bathroom  স্নানাগার
batsman  ব্যাটসম্যান
battery  ব্যাটারি
batting  ব্যাটিং
battle  যুদ্ধ
battlefield  যুদ্ধক্ষেত্র
battlefront  যুদ্ধক্ষেত্র
battleground  যুদ্ধক্ষেত্র
bay  উপসাগর
beach  সমুদ্র-সৈকত
beaches  সমুদ্র-সৈকত
beak  পাখির ঠোঁট
beams  তরঙ্গ
bear  ভালুক
bear  বহন করা
bearable  বহনযোগ্য
bearded  দাড়িওয়ালা
bearer  বাহক
bearing  বেয়ারিং
beat  পরাজিত করা
beatific  স্বর্গসুখদায়ক
beautiful  সুন্দর
beautifully  সুন্দরভাবে
beauty  সৌন্দর্য
because  কারণ
because  কারণ
become  হওয়া
bed  বিছানা
bedroom  শোয়ার ঘর
beer  বিয়ার
before  আগে
before  পূর্বে
beget  জন্ম দেওয়া
begin  শুরু হওয়া
begining  সূচনা
beginning  শুরু
behalf  তরফ থেকে
behave  আচরণ করা
behavior  আচরণ
behaviour  আচরণ
beheading  শিরোচ্ছেদ
behind  পেছন
behold  দেখা
being  হওয়া
belated  বিলম্বিত
belch  ঢেকুর
belching  ঢেকুর তোলা
belief  বিশ্বাস
belly  পেট
belong  অন্তর্ভুক্ত হওয়া
belong  অন্তর্ভুক্ত হওয়া
beloved  প্রিয়তম
below  নিচে
belt  বন্ধনী
bend  বাঁকান
benefit  সুবিধা
benevolence  পরোপকারী
berth  রেলের কামরায় শয়নস্থান
beset  চারদিক থেকে অবরোধ করা
besmirch  বদনাম করা
best  সবচেয়ে ভাল
best  সেরা
bet  বাজি ধরা
bet  বাজি ধরা
beta  বেটা
better  ভাল
better  ভাল
better  তুলনামূলক ভাবে ভাল
betterment  উন্নতিসাধন
between  মধ্যে
beware  সতর্ক হওয়া
bi  দুই
biannual  দ্বিবার্ষিক
biblical  বাইবেলিয়
bibulous  শোষক
bicycling  বাই-সাইকেল চালানো
big  বড়
bigger  আরো বড়
bill  বিল
billion  বিলিয়ন
bimonthly  দ্বিমাসিক
binary  বাইনারি
bind  বাইন্ড
biochemical  জৈব-রাসায়নিক
biochemistry  প্রাণ-রসায়ন
bioengineer  জৈব প্রযুক্তিবিদ
biography  জীবনী
biological  জৈবিক
biology  জীববিদ্যা
biophysicist  জৈব-পদার্থবিদ
bird  পাখি
birth  জন্ম
birthday  জন্মদিন
birthrate  জন্মের হার
bit  বিট
bitch  কুক্কুরী
bite  কামড়ানো
bits  বিট
black  কাল
blackberry  ব্ল্যাকবেরি
blacklist  কালো তালিকাভুক্ত করা
blackmail  ব্ল্যাকমেইল
blacksmith  লোহার
blame  দোষারোপ
blame  দোষারোপ করা
blank  ফাঁকা
blank  ফাঁকা হওয়া
blanking  মুছে ফেলা
blanket  কম্বল
blast  বিস্ফোরণ
blasting  প্রবলবেগে
bleach  সাদা করা
bleeding  রক্তক্ষরণ
blended  মিশ্রিত
blessing  আশির্বাদ
blind  অন্ধ
blind  অন্ধ
blink  জ্বলজ্বল
blink  জ্বলানেভা
blister  ফোসকা
block  ব্লক
block  বনধ্
block  বাধা দেওয়া
blocks  ব্লক
blog  ব্লগ
blog  ব্লগিং করা
blogging  ব্লগিং
bloody  রক্তাক্ত
blooming  বিকশিত
blossom  প্রস্ফুটিত হওয়া
blowfish  ব্লোফিশ
blowing  প্রবাহিত
blowup  ফোলানো
blue  নীল
bluff  ধাপ্পা
blur  অস্পষ্ট ছাপ
blur  ঝাপসা
board  বোর্ড
boarder  আবাসিক
boarding  আবাসিক
boat  নৌকা
boats  নেৌকা
bobby  ববি
body  দেহ
bodyguard  দেহরক্ষী
boil  ফোটান
bold  জোরালো
bomb  বোমা
bombastic  শব্দাড়ম্বরপূর্ণ
bomber  বোমা হামলাকারী
bombing  বোমা হামলা
bond  বন্ধন
bond  বন্ড
bone  হাড়
bonus  অধিবৃত্তি
book  গ্রন্থ
book  সংরক্ষণ করা
booklet  পুস্তিকা
books  পুস্তক
boom  উচ্চ প্রবৃদ্ধি
boom  আকস্মিক বৃদ্ধি পাওয়া
booming  সমৃদ্ধ
boon  অনুগ্রহ
boost  গতি বৃদ্ধি
booster  গতি বৃদ্ধিকারক
boot  বুট
border  সীমারেখা
boredom  একঘেঁয়েমি জনিত বিরক্তি
boring  বিরক্তিকর
born  জন্ম নেওয়া
borrow  ধার করা
borrower  ঋণগ্রহীতা
borrowing  ধার
bosons  বোসন
botanist  উদ্ভিদবিজ্ঞানী
botched  জোড়াতালি দেওয়া
both  উভয়
bother  বিরক্ত করা
bottle  বোতল
bottom  তলা
bough  গাছের বড় ডাল
bound  বদ্ধ
boundary  সীমানা
bouquet  ডালি
bow  মাথা নত করা
bowling  বোলিং
boxes  বাক্স
boy  বালক
boy  ছেলে
boycott  বর্জন
boycott  বর্জন করা
boyfriends  ছেলে বন্ধু
boyish  বালকসুলভ
boys  ছেলে
bra  বক্ষবন্ধনী
bracket  বন্ধনী
brackets  বন্ধনী
brain  বুদ্ধি
brainwashing  মগজধোলাই
branch  শাখা
brand  ব্র্যান্ড
brave  সাহসী
brave  সাহসী
bread  রুটি
breadth  চওড়া
break  বিরতি
break  ভাঙা
breast  স্তন
breath  শ্বাস‌ প্রশ্বাস
breathing  নিঃশ্বাস-প্রশ্বাস
breathlessly  রুদ্ধশ্বাসভাবে
bribery  ঘুষ আদান প্রদান
bridge  সেতু
bridge  সেতুবন্ধন করা
brief  সংক্ষিপ্ত
brief  সংক্ষিপ্ত
brief  সংক্ষেপে বলা
bright  উজ্জ্বল
brighten  আলোকিত করা
brightener  উজ্জ্বল-কারক
brightness  ঔজ্জ্বল্ল
bring  আনা
broad  ব্যাপক
broadcast  সম্প্রচার
broadcaster  সম্প্রচারকারী
broadcasters  সম্প্রচারকারী
broadcasting  সম্প্রচার
broadly  বিস্তীর্ণভাবে
broken  ভাঙা
broker  দালাল
brothel  পতিতালয়
brother  ভাই
brotherism  ভাতৃত্ব
brouhaha  কোলাহল
brown  বাদামী
brown  খয়েরী
browse  ব্রাউজ
browsing  ব্রাউজিং
browser  ব্রাউজার
bruise  কালশিরা
brutal  পাশবিক
brutality  নৃশংসতা
bubble  বুদবুদ
buddy  বন্ধু
budget  বাজেট
buffalo  মোষ
buffer  বাফার
bug  প্রোগ্রাম ত্রুটি
bug  বাগ
buggy  ত্রুটিপূর্ণ
bugle  ভেরি
bugs  ত্রুটি
build  নির্মাণ
build  নির্মাণ করা
building  ভবন
building  গড়া
built  নির্মিত
builtin  অন্তর্নির্মিত
bulk  অধিকাংশ
bullet  বুলেট
bullfighter  বৃষের সঙ্গে লড়া
bunch  গুচ্ছ
bundle  আঁটি
burden  বোঝা
burial  কবর
burn  পোড়ান
burn  পোড়ান
burner  চুল্লি
burning  লিখন
burst  বিস্ফোরিত হওয়া
bury  সমাহিত করা
bus  বাস
buses  বাস
business  ব্যবসা
businessman  ব্যবসায়ী
businessmen  ব্যবসায়ী
businesswoman  মহিলা ব্যবসায়ী
busy  ব্যস্ত
but  কিন্তু
butchery  কসাইখানা
butt  পাছা
butterfly  প্রজাপতি
buttery  তেলতেলে
button  বাটন
buttons  বাটন
buttress  মদত দেওয়া
buy  কেনা
buy  ক্রয় করা
buy  ক্রয় করা
buyer  ক্রেতা
by  দ্বারা
bye  বিদায়
bytes  বাইট
c  সি
cabbage  বাঁধাকপি
cable  কেবল
cables  কেবল
cache  ক্যাশ
cafe  রেস্তরাঁ
cage  খাঁচা
cake  কেক
calculable  গণনযোগ্য
calculate  গণনা
calculated  গণনাকৃত
calculating  গণনা করছে
calculation  গণনা
calculator  ক্যালকুলেটর
calculus  পাথুরি রোগ
calendar  বর্ষপঞ্জি
calibration  পরিমাপ নির্দিষ্ট-করণ
call  ডাক দেওয়া
call  ডাক দেওয়া
caller  আহ্বায়ক
calm  শান্ত
camel  ঊট
cameras  ক্যামেরা
camouflage  ধুলো দেওয়া
camp  শিবির
campaign  সংগঠিত প্রচারকার্য
camps  শিবিরগুলি
campus  ক্যাম্পাস
can  করতে পার
canal  খাল
canals  খাল
cancel  বাতিল
cancel  বাদ দেওয়া
canceled  বাতিলকৃত
cancellation  বাতিল
cancer  ক্যান্সার
candidate  প্রার্থী
cannot  গেল না
canvas  চিত্রপট
canyon  গিরিখাত
cap  টুপি
capabilities  সক্ষমতা
capability  সক্ষমতা
capable  সক্ষম
capacious  প্রশস্ত
capacities  ধারনক্ষমতা
capacitor  ধারক
capacity  ক্ষমতা
capita  মাথাপিছু
capital  রাজধানী
capital  রাজধানী
capitalism  পুঁজিবাদ
capitalist  পুঁজিপতি
capitalist  পুঁজিপতি
capsicum  লঙ্কা
captain  অধিনায়ক
caption  শিরোনাম
capture  অধিগ্রহণ করা
car  গাড়ি
card  কার্ড
cardamom  এলাচ
cardboard  কার্ডবোর্ড
cardboard  পিজবোর্ড
cards  তাস
care  যত্ন
career  জীবিকা
carefully  যত্নসহকারে
caretaker  তত্ত্বাবধায়ক
cargo  মাল
carnage  হত্যাকান্ড
carnival  মহোৎসব
carpenter  ছুতোর
carriage  বাহন
carried  বহন করা
carrier  বাহক
carrot  গাজর
carry  বহন করা
carry  বহন করা
cartridge  কার্তুজ
carver  মাংস-কাটা ছুরি
carving  খোদাই করা কোন জিনিস
cascade  জলপ্রপাত
case  অক্ষরের ছাঁদ
case  ক্ষেত্র
cases  ঘটনা
cash  নগদ
cashier  কোষাধ্যক্ষ
cask  তরল জিনিস রাখিবার পিপা
casket  মণি-রত্নাদি রাখিবার ছোট বাক্স
cassette  ক্যাসেট
cassettes  ক্যাসেট
cassocked  আলখিল্লা পরিহিত
cast  নিক্ষেপ করা
caste  যবর্ণ
castigate  প্রহার করা
castigation  ভর্ৎসনা
casting  নিক্ষেপণ
castle  দুর্গ
casual  অসতর্ক
casually  দৈবাৎ
casualty  দুর্ঘটনা
cat  বিড়াল
catalog  সুবিন্যস্ত তালিকা
catalogue  তালিকা
catalyst  অনুঘটক
catapult  প্রাচীনযুগের পাথর ছুড়িবার যন্ত্র
cataract  জলপ্রপাত
catastrophe  চরম বিপর্যয়
catastrophic  সর্বনাশা
catch  ধরা
catch  ধরা
catching  সংক্রামক
catchy  চিত্তাকর্ষক
catechism  প্রশ্নোত্তর দ্বারা শিক্ষাদান
categorical  বিভাগীয়
categories  শ্রেণীবিভাগ
categorize  শ্রেনীবিভাগ করা
category  শ্রেণীবিভাগ
cater  পরিবেশন
catered  পরিবেশিত
caterpillar  শুঁয়োপোকা
cathedral  বিশপের অধীন গির্জা
catheter  মূত্র নিষ্কাশনের নল বিশেষ
cathode  ক্যাথোড
cattle  গবাদি পশু
cattle  গৃহপালিত পশু
cauliflower  ফুলকপি
cause  কারণ
cause  ঘটান
caused  ঘটায়
causeway  পাথরে বাঁধানো উঁচু রাস্তা
cauterize  উত্তপ্ত শলাকা দ্বারা পোড়ান
caution  সতর্কতা
caution  সতর্ক করা
cautious  সতর্ক
cavalier  অশ্বারোহী সৈনিক
cave  গুহা
cave  গুহা
cavity  গহ্বর
cease  বিরত থাকা
ceasefire  যুদ্ধবিরতি
ceaseless  অবিরাম
ceiling  ঘরের ছাদের ভিতরের দিক
celebrate  উদযাপন
celebration  উদযাপন
celebrity  বিখ্যাত ব্যক্তি
celerity  বেগ
celestial  স্বর্গীয়
cell  কক্ষ
cellophane  সেলোফেন
cellular  কোষবিশিষ্ট
cellulose  সেলুলোজ
cement  সিমেন্ট
cemetery  সমাধিস্থল
censorship  বাধানিষেধ
census  জনগণনা
cent  শত
cent  শত
center  কেন্দ্র
center  মধ্য
center  কেন্দ্রে স্থাপন করা
centimeters  সেন্টিমিটার
central  মধ্য
central  কেন্দ্রীয়
centre  কেন্দ্র
centric  কেন্দ্রিক
century  শতাব্দী
cereal  খাদ্যশস্য
ceremonial  আনুষ্ঠানিক
ceremonially  আনুষ্ঠানিকভাবে
ceremony  উৎসব
certain  কতগুলি
certainly  নিশ্চিতভাবে
certificate  শংসাপত্র
certificates  সনদপত্র
certification  সত্যতা অনুমোদন
certify  শংসাপত্র দেওয়া
chagrin  হতাশা
chain  শৃঙ্খল
chair  কেদারা
chairman  সভাপতি
challenge  প্রতিদ্বন্দ্বিতা
challenging  প্রতিদ্বন্দ্বিতাপূর্ণ
chamber  কক্ষ
champagne  শ্যাম্পেন
champion  বিজয়ী
chance  ভাগ্যক্রমে ঘটে এমন
chance  সুযোগ
change  পরিবর্তন
change  পরিবর্তন করা
changed  পরিবর্তিত
changes  পরিবর্তন
changing  পরিবর্তনশীল
channel  চ্যানেল
channels  চ্যানেল
chapter  অধ্যায়
chapters  পরিচ্ছেদ
char  অক্ষর
character  অক্ষর
characteristic  বৈশিষ্ট্য
characteristically  বৈশিষ্টময়ভাবে
characteristics  গুণাবলিসমূহ
characterization  বৈশিষ্ট্য
characterize  বৈশিষ্ট্য বর্ণনা করা
characters  অক্ষর
charcoal  চারকোল
charge  আধান
charge  আধানযুক্ত করা
charged  আধানযুক্ত
chariot  রথ
charitable  পরহিতকর
charm  আকর্ষণ শক্তি
chart  তালিকা
charter  ফরমান
chastity  সতীত্ব
chat  আড্ডা
chat  চ্যাট
cheap  সস্তা
cheat  প্রতারণা করা
check  পরীক্ষা করা
checked  পরীক্ষিত
checker  পরীক্ষক
checking  পরীক্ষা করা
checking  পরীক্ষা করছে
cheek  গাল
cheer  উল্লাস
cheerful  আনন্দময়
cheerfulness  আনন্দ
cheers  হর্ষোল্লাস
chemical  রাসায়নিক
chemise  মহিলাদের লম্বা ঢিলেঢালা অন্তর্বাস বিশেষ
chemist  রসায়নবিদ
chemistry  রসায়ন
chess  দাবা
chew  চর্বণ করা
chew  চিবিয়ে খাওয়া
chewing  চিবানো
chicken  মুরগি
chicly  সৌনাভ
chief  মুখ্য
chieftain  দলনেতা
chignon  গুছি
child  চাইল্ড
childish  ছেলেমি
children  শিশু
chili  মরিচ
chip  চীপ
chirpy  হাসিখুশী
chloride  ক্লোরাইড
choice  পছন্দ
choice  পছন্দ
choices  পছন্দ
choir  গির্জার গায়কদল
choke  কন্ঠরোধ করা
choke  শ্বাসরোধ করা
choke  শ্বাসরোধ করা
cholera  কলেরা
choose  বেছে নিন
chop  টুকরো টুকরো করে কাটা
chop  টুকরো করে বা কুচি কুচি করে কাটা
chord  বাদ্যযন্ত্রের তার
chorus  গায়কদল
chosen  নির্বাচিত
christen  নামকরণ করা
chronicle  ধারাবিবরণী
chuckle  খিকখিক করে হাসি
chum  অন্তরঙ্গ বন্ধু
chutney  আচার
cigar  চুরুট
cigarette  সিগারেট
cinema  সিনেমা
circle  বৃত্ত
circuit  সার্কিট
circular  বৃত্তাকার
circular  বৃত্তাকার
circulate  প্রদক্ষিণ করা
circumpolar  মেরু পরিবৃত্ত
circumstance  পরিস্থিতি
circumstances  পরিস্থিতি
circumvention  বোকা বানান
circus  সার্কাস
citation  উদ্ধৃতি
cite  উদ্ধৃতি দেওয়া
cities  নগরী
citizen  নাগরিক
city  শহর
citywide  নগরব্যপী
civic  নাগরিক
civil  অসামরিক
civilian  অসামরিক ব্যাক্তি
civilization  সভ্যতা
claim  দাবী
claim  দাবী করা
clarity  স্পষ্টতা
clash  সঙ্ঘর্ষ
clashes  সঙ্ঘর্ষ
class  শ্রেনী
classes  শ্রেণী
classic  ক্লাসিক
classical  সনাতন
classically  সনাতনভাবে
classification  শ্রেণীবিভাগ
classified  শ্রেণীকৃত
classify  শ্রেণীভুক্ত করা
classmate  সহপাঠী
clay  কাদা
clean  পরিষ্কার
clean  পরিচ্ছন্ন
clean  পরিষ্কার করা
cleaner  বেশি পরিষ্কার
cleaning  পরিষ্কার
cleanly  পরিচ্ছন্নভাবে
cleanse  সাফ করা
cleanup  পরিষ্কার
cleanups  পরিষ্কার
clear  পরিষ্কার
clear  মুছে ফেলো
clear  মুছে ফেলা
clearly  স্পষ্টভাবে
clerk  করণীক
clever  চতুর
click  ক্লিক
click  ক্লিক করা
clicking  ক্লিক করা হলে
client  গ্রাহক
clients  ক্লায়েন্ট
climate  জলবায়ু
climb  আরোহণ করা
climb  আরোহণ করা
clinic  ক্লিনিক
clinical  চিকিৎসার জন্য
clip  ক্লিপ
clipboard  ক্লীপবোর্ড
clock  ঘড়ি
clock  সময় লাগান
clockwise  ডানাবর্তী
clog  অবরোধ করা
clone  ক্লোন
clone  ক্লোন করা
cloning  ক্লোনিং
close  নিকট
close  বন্ধ
close  নিকটে
close  বন্ধ করা
closed  বন্ধ
closer  নিকটতর
closer  আরো কাছে
closing  শেষাংশ
closing  সমাপ্তি
closure  বন্ধ
clot  জমাট বাঁধা
cloth  জামাকাপড়
clothe  পোষাক
clothes  পোষাক সমূহ
clothing  পোশাক
cloud  মেঘ
cloud  মেঘ
clove  লবঙ্গ
club  ক্লাব
clue  সূত্র
cluster  গুচ্ছ
cm  সেঃ মিঃ
coach  কামরা
coaches  কামরা
coaching  কোচিং
coal  কয়লা
coalesce  একাত্ম হওয়া
coalition  জোট
coast  উপকূল
coastal  উপকূলবর্তী
coastline  উপকূলরেখা
coated  প্রলেপ দেওয়া
cobra  গোখরো সাপ
cocaine  কোকেন
cock  মোরগ
cockroach  তেলাপোকা
coconut  নারকেল
code  কোড
coding  কোডিং
coexist  সহাবস্থান করা
coffee  কফি
cogently  দৃঢ়ভাবে
coin  মুদ্রা
coincide  সামঞ্জস্যপূর্ণ হওয়া
coincidence  দৈবঘটনা
cold  শীতল
coldly  ঠান্ডাভাবে
collaboration  সহযোগিতা করা
collage  কোলাজ
collapse  ভেঙ্গে পড়া
collapse  ভেঙে পড়া
colleague  সহকর্মী
collect  সংগ্রহ করা
collecting  সংগ্রহকরণ
collection  সংগ্রহ
collective  সম্মিলিত
collectively  সামগ্রিকভাবে
college  মহাবিদ্যালয়
colleges  মহাবিদ্যালয়
collision  সংঘর্ষ
colon  কোলন
colonial  ঔপনিবেশিক
colonies  উপনিবেশ
colony  উপনিবেশ
color  রঙীন
color  রং
colored  রঙীন
colors  রং
coloured  রঙীন
column  কলাম
columns  কলাম
coma  কোমা
comb  চিরুনি
combination  সম্মিলন
combinations  বিন্যাস
combined  সম্মিলিত
come  আস
come  আসা
comedian  ভাঁড়
comedy  কৌতুক
comes  আসে
comet  ধূমকেতু
comfort  আরাম
comfortable  আরামদায়ক
coming  আসছে
comma  কমা
command  কমান্ড
command  কম্যান্ড
commas  কমা
commemorate  স্মরনীয় করে রাখা
comment  মন্তব্য
comment  মন্তব্য করা
comments  মন্তব্য
commerce  বাণিজ্য
commercial  বাণিজ্যিক
commercially  বাণিজ্যিকভাবে
commerical  বাণিজ্যিক
commissar  কমিসার
commissioner  কমিশনার
committee  কমিটি
committees  কমিটি
commodity  পণ্য
common  সাধারণ
common.sense  সাধারণ জ্ঞান
commonly  সাধারণভাবে
commons  কমনস
commonwealth  কমনওয়েলথ
communal  সাম্প্রদায়িক
communicate  যোগাযোগ করা
communication  যোগাযোগ
communications  যোগাযোগ
communicative  আলাপী
communism  বামপন্থা
communist  কম্যুনিষ্ট
communities  সম্প্রদায়
community  সম্প্রদায়
compact  নিবিড়
companies  কোম্পানি
companion  সহচর
company  কোম্পানি
compare  তুলনা
compare  তুলনা করা
comparison  তুলনা
compatibility  সঙ্গতিপূর্ণতা
compatible  সঙ্গতিপূর্ণ
compel  জোর করা
compensation  ক্ষতিপূরণ
compete  প্রতিযোগিতা
competition  প্রতিযোগিতা
competitive  আকর্ষণীয়
competitiveness  প্রতিযোগিতা
competitor  প্রতিযোগী
compilation  সঙ্কলন
compile  সঙ্কলন করা
compiled  কম্পাইলকৃত
complain  অভিযোগ
complaint  নালিশ
complete  সম্পূর্ণ
complete  শেষ করা
completed  সম্পন্ন
completely  সম্পূর্ণভাবে
completion  পরিপূরণ
complex  জটিল
complexity  জটিলতা
compliance  সম্মত
compliant  সম্মত
complication  জটিলতা
component  উপাদান
components  উপাদান
compose  একত্র করে গঠন করা
composed  গঠিত
composed  গ্রন্থিত
composer  রচয়িতা
composite  যৌগিক
composition  গ্রন্থন
compound  যৌগ
compress  সঙ্কুচিত করা
compressed  কম্প্রেসকৃত
compressed  সঙ্কুচিত
compression  কম্প্রেশন
comprise  গঠিত হওয়া
computation  গণনা
compute  গণনা করা
computers  কম্পিউটার
comrade  সঙ্গী
conceal  গায়েব করা
concealed  গুপ্ত
concede  মেনে নেওয়া
conceive  কল্পনা করা
conceive  গর্ভবতী হওয়া
concentrate  মনোযোগ দেওয়া
concentration  মনঃসংযোগ
concern  উদ্বিগ্ন হওয়া
concern  উদ্বিগ্ন হওয়া
concerning  সম্পর্কে
concert  মিলন
concise  সংক্ষিপ্ত
concluding  শেষকালীন
conclusion  সিদ্ধান্ত
conclusive  চূড়ান্ত
condemn  নিন্দা করা
condensation  ঘনীভবন
condition  অবস্থা
conditional  শর্তাধীন
conditions  অবস্থা
condom  কন্ডোম
condominium  অ্যাপার্টমেন্ট
conduct  পরিচালনা করা
conductor  বাহক
confederation  কনফেডারেশন
confer  খেতাব প্রদান করা
conference  অধিবেশন
confidence  আত্মবিশ্বাস
confident  আত্মবিশ্বাসী
confidential  গোপনীয়
configure  কনফিগার
configuration  কনফিগারেশন
confine  সীমাবদ্ধ করা
confined  বদ্ধ
confinement  গারদ
confirm  দৃঢ়তরভাবে প্রতিপন্ন করা
confirmation  নিশ্চিত প্রমাণ
confirmed  নিশ্চিত
conflict  সংঘাতে জড়িয়ে পড়া
confluence  সঙ্গম
confluent  নদী-সঙ্গম
conform  মেনে চলা
conformist  অনুগামী ব্যক্তি
conformity  সাদৃশ্য
confound  তালগোল পাকান
confused  বিভ্রান্ত
confusing  বিভ্রান্তকর
confusion  বিভ্রান্তি
congestion  জট
congratulate  অভিনন্দন জানান
congratulation  অভিনন্দন
congratulations  অভিনন্দন
congratulations  অভিনন্দন
congress  কংগ্রেস
conjecture  আন্দাজ
conjugal  দাম্পত্য
conjunction  যুক্তাক্ষর
connect  সংযোগ কর
connect  সংযোগ স্থাপন
connected  সংযুক্ত
connecting  সংযোগ স্থাপিত হচ্ছে
connection  সংযোগ
connections  সংযোগ
conquer  জয় করা
conscience  বিবেক
consciousness  সচেতনতা
consecutive  পরপর
consensus  ঐক্যমত
consent  অনুমোদন
consent  অনুমোদন  করা
consequence  ফল
consequent  অনুবর্তী
consequently  ফলে
conservative  সংরক্ষণশীল
conservatively  রক্ষণশীলভাবে
consider  বিবেচনা
consideration  বিবেচনা
consider  ছাড় দেওয়া
consist  গঠিত
consistency  ধারাবাহিকতা
consistently  ধারাবাহিকভাবে
consists  গঠিত
consolation  সান্তনা
console  কনশোল
consolidation  দৃঢ়করণ
consonant  ব্যঞ্জণবর্ণ
consortium  সংঘ
conspiracy  ষড়যন্ত্র
constancy  অপরিবর্তনীয়তা
constant  ধ্রুবক
constantly  অবিরামভাবে
constellation  তারামণ্ডলী
constituent  নির্বাচনকারী
constitute  গঠন করা
constitution  সংবিধান
constitutionality  সাংবিধানিকতা
constrain  বাধ্য করা
construct  নির্মান করা
construction  নির্মাণ
constructive  গঠনমূলক
consult  পরামর্শ করা
consultation  আলোচনা
consumer  ভোক্তা
consuming  খাওয়া
contact  যোগাযোগ
contact  যোগাযোগ করা
contacting  যোগাযোগ করা হচ্ছে
contagious  সংস্পর্শের মাধ্যমে সংক্রামক
contain  ধারণ করা
container  ধারক
containers  ধারক
containing  ধারণ করে
contains  ধারণ করা
contaminated  দূষিত
contemporary  সমকালীন
content  ভিতরের উপাদান
contents  অভ্যন্তরস্থ বস্তু
contestant  প্রতিযোগী
context  প্রসঙ্গ
contexts  প্রসঙ্গ
continence  সংযম
continent  মহাদেশ
continual  অবিরাম
continue  অগ্রসর হওয়া
continue  চালিয়ে যাওয়া
continues  চলছে
continuing  চলমান
continuous  ক্রমাগত
continuously  অবিরামভাবে
contraception  গর্ভনিরো‌ধ
contract  চুক্তি
contraction  সঙ্কোচন
contrast  বৈসাদৃশ্য
contribute  অংশপ্রদান
contributed  দানকৃত
contribution  অবদান
contributions  অবদানসমূহ
contributor  অংশ গ্রহণকারী
contributors  অংশ গ্রহণকারীগণ
control  নিয়ন্ত্রণ
control  নিয়ন্ত্রণ করা
controlled  নিয়ন্ত্রিত
controls  নিয়ন্ত্রণ করে
controversial  বিতর্কিত
controversy  বিতর্ক
convection  পরিচলন
convenience  সুবিধা
convenient  সুবিধাজনক
convention  কনভেনশন
conventions  প্রথা
conversation  কথোপকথন
conversations  কথোপকথন
conversely  বিপরীতভাবে
conversion  রূপান্তর
convert  রূপান্তর
convert  রূপান্তর করা
converter  রূপান্তরকারী
convey  পৌঁছে দেওয়া
conveyance  যানবাহন
convict  দণ্ডিত অপরাধী
convince  দৃঢ়প্রত্যয় উত্পাদন করা
cook  রাঁধুনি
cook  কুক
cook  রান্না করা
cookies  কুকি
cool  ঠান্ডা
cool  ঠান্ডা করা
coolness  শীতলতা
cooperate  সহযোগিতা করা
cooperation  সহযোগিতা
cooperative  সহযোগী
coordinate  স্থানাংক
coordinator  সমন্বয়সাধনকারী
cop  পুলিশ
copied  কপিকৃত
copies  কপি
copy  কপি করা
copying  কপি করা হচ্ছে
copyright  কপিরাইট
copyright  সত্ত্বাধিকার
cordial  আন্তরিক
core  মূল
cork  কর্ক
corn  ভুট্টা
cornea  কর্নিয়া
corner  কোণ
cornerstone  মূলভিত্তি
corollary  অনুসিদ্ধান্ত
corporate  যৌথ
corpse  মৃতদেহ
correct  সঠিক
correct  ত্রুটিমুক্ত
corrected  সংশোধিত
correction  সংশোধন
correctly  সঠিকভাবে
correlated  পরস্পর সম্পর্কযুক্ত
correspond  সঙ্গতিপূর্ণ হওয়া
correspondent  প্রতিনিধি
corresponding  সংশ্লিষ্ট
corridor  করিডর
corroborate  সমর্থিত হওয়া
corrupt  বিকৃত
corrupt  দুর্নীতিবাজ
corruption  দুর্নীতি
corset  কাঁচুলি
cosmological  মহাবিশ্বতত্ত্বমূলক
cosmology  সৃষ্টিতত্ত্ব
cosmopolitan  বিশ্বজনীন
cost  খরচ
cost  মূল্য দেওয়া
costliest  সবচেয়ে দামি
costly  দামী
costs  খরচ
costume  পোশাক
cosy  আরামদায়ক
cottage  কুটির
cotton  তুলা
cough  কাশি
council  পরিষদ
counsel  উপদেশ
count  গণনা
count  গুনতি
count  গণনা করা
counter  কাউন্টার
counterfeit  নকল
counterpart  প্রতিরুপ
counting  গণনা
countries  দেশগুলো
country  দেশ
countryman  দেশবাসী
county  কাউন্টি
coup  সামরিক অভ্যুথান
couple  দম্পতি
courage  সাহসীকতা
course  বিষয়
court  কোর্ট
courteous  নম্র
courts  আদালত
cover  কভার
cover  ঢাকা দেওয়া
coverage  প্রতিবেদন প্রচার
covered  আবৃত
covers  কভার
cow  গরু
cowboy  রাখাল
coy  নম্র
coyly  লাজ-নম্র হয়ে
coyness  নম্রভাব
cpu  সিপিইউ
crack  সুদক্ষ
cradle  দোলনা
crane  সারস
cranky  বদমেজাজী
crash  ভেঙ্গে পড়া
crash  ভেঙ্গে পড়া
crashed  ক্র্যাশ
crashed  ক্র্যাশকৃত
crashed  ভেঙে পড়েছে
crater  খাদ
crave  মিনতি করা
craving  আকুল কামনা
craziness  পাগলামি
create  তৈরি করা
created  সৃষ্ট
creating  তৈরি করছে
creation  সৃষ্টি
creative  সৃজনকর
creativity  সৃজনশীলতা
creator  সৃষ্টিকারী
credential  প্রশংসাপত্র
credibility  বিশ্বাসযোগ্যতা
credit  ধার দেওয়া
credits  স্বীকৃতি
crescent  হেলাল
crest  শিখর
crested  ঝোঁটন
crew  চালক
cricket  ক্রিকেট
criminal  অপরাধমূলক
criminal  দূষ্কৃতী
cripple  পঙ্গু
cripple  পঙ্গু করা
crisis  সঙ্কট
criteria  বিচারধারা
criterion  বিচারধারা
critic  সমালোচক
critical  চরম সঙ্কটপূর্ণ
criticism  সমালোচনা
criticize  সমালোচনা করা
crocodile  কুমির
crony  অন্তরঙ্গ বন্ধু
crooked  অসাধু
crop  ফসল
crop  ফসল ফলান
crops  ফসল
cross  অতিক্রম
cross  অতিক্রম করা
cross  পার করা
crow  কাক
crow  কর্কশধ্বনি করা
crowd  ভীড়
crowd  ভিড় করা
crown  মুকুট
crown  শিরোপা দেওয়া
crude  অপরিপক্ক
cruel  নিষ্ঠুর
crumble  ভেঙে টুকরো টুকরো করা, পতন হওয়া
crush  নিষ্পেষণ
cry  কাঁদা
crypt  ক্রিপ্ট
crystal  স্ফটিক
cube  ঘনক্ষেত্র
cuckoo  কোকিল
cucumber  শশা
cuff  জামার আস্তিনের নিম্নাংশ
culmination  মধ্যগমন
cultivate  চাষ করা
cultivation  চাষ
cultural  সাংস্কৃতিক
culture  সংস্কৃতি
cultured  বিনয়ী
cultures  সংস্কৃতি
cumin  কাল জিরা
cumulative  ক্রমবর্ধমান
cup  কাপ
cup  পেয়ালা
curd  দধি
curl  বাঁক
curled  বক্র
currency  টাকা
current  বর্তমান
current  বর্তমানে ব্যবহৃত
currently  অধুনা
currently  বর্তমানে
curriculum  পাঠক্রম
curse  অভিশাপ
curtain  পর্দা
curvature  বক্রতা
curve  বক্র
curves  বক্ররেখা
cusp  শৃঙ্গ
custom  স্বনির্বাচিত
custom  প্রথা
customer  গ্রাহক
customers  খদ্দের
customization  স্বনির্বাচন
customized  স্বনির্বাচিত
cut  কাট
cut  কাটা
cut  কাটো
cut  কেটে ফেলা
cycle  চক্র
dad  বাবা
daddy  বাবা
dailies  দৈনিক সংবাদপত্র
daily  প্রতিদিন
dally  অলস সময় কাটানো
dam  বাঁধ
damage  ক্ষতি
damage  ক্ষতি করা
damaged  ক্ষতিগ্রস্ত
damned  অভিশপ্ত
dampness  আর্দ্রতা
damsel  তরুণী
dance  নৃত্য
dance  নাচা
danger  বিপদ
dangerous  বিপজ্জনক
dark  অন্ধকার
dark  আঁধার
darker  আরো অন্ধকার
darkest  অন্ধকারতম
darkness  আঁধার
darkroom  অন্ধকার ঘর
darling  প্রিয়তম
das  দাস
data  ডেটা
data  তথ্য
database  ডেটাবেস
databases  ডেটাবেস
date  তারিখ
dates  তারিখ
dating  ডেটিং
daughter  কন্যা
davenport  কারুকার্যপূর্ণ লেখার টেবিল
dawn  ভোর
day  দিন
daylight  দিনের আলো
daylong  দিনব্যাপী
days  দিন
daytime  দিবাভাগ
daytime  দিনের বেলা
dd  ডিডি
deactivated  অচল
dead  মৃত
deadlock  অচলবস্থা
deadly  মারাত্নক
deaf  বধির
deal  চুক্তি
deal  চুক্তি করা
deal  দেবদারু কাঠ
dean  ডিন
dear  প্রিয়
dearth  অভাব, অনটন, আকাল
death  মৃত্যূ
deathless  মৃত্যুহীন
debate  বিতর্ক
debit  নগদ
debonair  প্রফুল্ল
debris  ধ্বংসাবশেষ
debt  ঋণ
debug  ত্রুটিমুক্ত করা
debug  ত্রুটিমুক্ত করা
debugging  ডিবাগিং করা
debugging  ত্রুটিমুক্ত করা
debut  অভিষেক
debut  অভিষেক হওয়া
decade  দশক
decadence  অধঃপতিত অবস্থা
decades  দশক
decaying  ক্ষয়শীল
decedent  মৃত ব্যক্তি
deceive  ঠকানো
deception  প্রবঞ্চনা
decide  নির্ধারণ করা
decimal  দশমিক
decimal  দশমিক
decision  সিদ্ধান্ত
decisive  চূড়ান্ত
declaration  ঘোষণা
declare  ঘোষণা করা
decline  অস্বীকার
decline  অস্বীকার করা
decline  পতন
declining  নামতে থাকা
decode  ডিকোডিং করা
decode  ডিকোডিং করা
decoded  ডিকোডকৃত
decoding  ডিকোডিং
decrease  হ্রাস
decrease  কমান
decry  নিন্দা করা
deduce  অনুমান করা
deduction  অনুমান
deem  গণ্য করা
deep  গভীর
deep.rooted  বদ্ধমূল
deeply  গভীরভাবে
deer  হরিণ
default  ডিফল্ট
default  স্বাভাবিক অবস্থায় ব্যবহৃত
defaults  ডিফল্ট অবস্থায়
defeat  পরাজয়
defeat  পরাজিত করা
defect  খুঁত
defendant  প্রতিবাদী
defensive  প্রতিরোধমূলক
defer  বিলম্বিত করা
deferent  শীঘ্রবৃত্ত
deferred  বিলম্বিত
defiance  আদেশ পালন করতে অস্বীকার করা
deficit  ঘাটতি
define  উল্লেখকরণ
defined  উল্লেখকৃত
definite  নিশ্চিত
definitely  নিশ্চিতভাবে
definition  সংজ্ঞা
defoliation  পাতা ঝরান
deformed  বিকৃত
deft  দক্ষ
degeneracy  অধঃপতন
degrees  ডিগ্রি
delay  বিলম্ব
delay  বিলম্বিত করা
delayed  বিলম্বিত
delegate  প্রতিনিধি
delete  মুছে ফেলা
deleting  মোছা হচ্ছে
deliberate  সুচিন্তিত
delicate  সুস্বাদু
delicious  সুস্বাদু
delight  উত্ফুল্লতা
delight  আনন্দ দেওয়া
delight  আনন্দিত হওয়া
delightful  আনন্দময়
delinquency  অপচার
deliver  বিলি করা
delivery  বিলি করা
delta  ডেলটা
delve  খনন করা
demand  চাহিদা
demand  দাবী করা
democracy  গণতন্ত্র
democratic  গনতন্ত্রী
demolish  ধ্বংস করা
demon  দানব
demonstrate  প্রতিপাদন করা
demoralization  আত্মবিশ্বাসহীনতা
denied  প্রত্যাখ্যাত
denominator  হর
dense  ঘন
density  ঘনত্ব
deny  অস্বীকার করা
department  বিভাগ
departure  বহির্গমন
depend  নির্ভর কর
dependency  নির্ভরতা
dependent  নির্ভরশীল
dependent  অধীন
depending  নির্ভর
deplore  গভীর পরিতাপ করা
deport  নির্বাসিত করা
deposit  জমা হওয়া
depositary  ন্যাসরক্ষক
deposition  গচ্ছিত রাখা
depression  হতাশা
depth  গভীরতা
deputy  সহকারী
derision  পরিহাস
derivative  উদ্ভূত
derive  উৎপত্তি নির্ণয় করা
deriving  উৎপন্ন
des  ডি-ই-এস
descend  অবতরণ
describe  বর্ণনা করা
described  বর্ণনাকৃত
describing  বর্ণনা করা হচ্ছে
description  বর্ণনা
descriptions  বর্ণনা
descriptive  বর্ণনামূলক
desert  মরুভূমি
deserve  যোগ্য হওয়া
design  নকশা
design  পরিকল্পনা করা
designer  নকশাকারী
desire  আকাঙ্খা
desired  প্রত্যাশিত
desktop  ডেস্কটপ
desperately  প্রাণপণে
despise  অবজ্ঞা করা
destination  গন্তব্য
destiny  নিয়তি
destitute  চরম অভাবগ্রস্ত
destroy  ধ্বংস করা
destruction  ধ্বংস
detach  বিযুক্তকরণ
detached  আলাদা
detail  পুঙ্খানুপুঙ্খ বর্ণনা
detailed  পুঙ্খানুপুঙ্খ
detailed  বিস্তারিত বর্ণনা
details  বিশদ বর্ণনা
details  বিস্তারিত
detain  আটকে রাখা
detect  সনাক্তকরণ
detected  সনাক্তকৃত
detection  সনাক্তকরণ
detective  গোয়েন্দা
detergent  ডিটার্জেন্ট
deteriorate  অবনতি হওয়া
deterioration  নষ্ট হয়ে যাওয়া
determine  নির্ধারণ
determine  নির্ধারণ করা
determining  গুরুত্বপূর্ণ
determinning  দৃঢ় সিদ্ধান্ত নেয়া, সংকল্প করা
deterrent  প্রতিরোধক
detonate  বিস্ফোরিত করা
develop  বিকশিত করা
developed  উন্নত
developer  ডেভেলপার
developers  ডেভেলপারগণ
developing  উন্নয়নশীল
development  উন্নতিসাধন
deviation  বিচ্যুতি
device  ডিভাইস
devices  ডিভাইস
devoid  বিহীন
devoted  অনুরক্ত
devotional  ভক্তিমূলক
devout  ধর্মপ্রাণ
dew  শিশির
diabolical  নারকীয়
diagnose  রোগ নির্নয় করা
diagnosis  রোগনির্ণয়
diagnostic  রোগনির্ণয় সম্পর্কিত
diagnostics  রোগনির্ণয়তত্ত্ব
diagonal  তির্যক
dial  ডায়াল
dial  ডায়াল করা
dialing  ডায়াল করা হচ্ছে
dialogue  কথোপকথন
diamond  হীরক
diarrhea  উদরাময়
diary  ডাইরি
dictation  আদেশ
dictionary  অভিধান
dictum  নীতি-বাক্য
die  মর
die  মরা
diesel  ডিজেল
diesel  ডিজেল
differ  ভিন্নমত হওয়া
difference  পার্থক্য
different  আলাদা
differently  আলাদাভাবে
difficult  কঠিন
difficulty  ঝামেলা
diffuse  পরিব্যাপ্ত
diffusion  বিকীর্ণ করা
dig  খনন করা
digest  সারসঙ্কলন সম্বলিত বই
digest  হজম করা
digit  অংক
digital  ডিজিট্যাল
dignity  মর্যাদা
diktat  নির্দেশনা
dilate  প্রসারিত করা
dilute  লঘু করা
dilution  লঘুকরণ
dimension  মাত্রা
dimensions  মাত্রা
dinner  সান্ধ্যভোজ
dip  নতি
diplomat  কূটনীতিক দূত
diplomatic  কূটনৈতিক
dire  ভয়াবহ, ভীষণ
direct  সরাসরি
direct  সরাসরি
direction  দিকনির্দেশনা
directionless  দিশাহীন
directionlessness  দিশাহীনতা
directly  সরাসরিভাবে
director  পরিচালক
directorate  পরিচালকবর্গ
directories  ডিরেক্টরী
directory  ডিরেক্টরি
directory  ডিরেক্টরী
disability  শারীরিক প্রতিবন্ধী
disable  অকার্যকর করা
disabled  নিষ্ক্রিয়
disabling  নিষ্ক্রিয়করণ
disadvantageous  অসুবিধাজনক
disagreement  অনৈক্য
disallow  অনুমতি না দেওয়া
disappear  অন্তর্ধান করা
disappointed  হতাশ
disappointingly  হতাশাগ্রস্ত হয়ে
disappointment  হতাশা
disarmament  নিরস্ত্রীকরণ
disaster  বিপর্যয়
disbelief  অবিশ্বাস
disc  ডিস্ক
discard  বাতিল
discarded  বাতিলকৃত
discerning  তীক্ষ্ণ-বুদ্ধি সম্পন্ন
disciplinary  নিয়মরক্ষা
discipline  শৃঙ্খলা
disclosed  উন্মুক্ত
disconnect  সংযোগ বিচ্ছিন্ন করা
disconnected  সংযোগ বিচ্ছিন্নকৃত
disconnecting  সংযোগ বিচ্ছিন্ন করা হচ্ছে
discount  ছাড়
discover  খুঁজে বার করা
discovery  আবিষ্কার
discreet  বিচক্ষণ
discreetly  বিচক্ষণভাবে
discriminate  বৈষম্যমূলক আচরণ করা
discrimination  বৈষম্য
discriminatory  পক্ষপাতমূলক
discuss  আলোচনা করা
discussion  আলোচনা
disdain  ঘৃণা করা
disease  জ্বরা
disembodied  বিদেহী
disk  ডিস্ক
diskette  ডিস্কেট
disks  ডিস্ক
dislike  অপছন্দ করা
dislocated  স্থানান্তরিত
dismante  ভেঙে ফেলা
disobedience  অসহযোগ
disobey  নির্দেশ না মানা
disorderly  বিশৃঙ্খল
displace  স্থানচ্যুত কর
display  ডিসপ্লে
display  পর্দা
display  প্রদর্শন করা
displaying  প্রদর্শনরত
displays  প্রদর্শন করে
dispute  বিতর্ক
dispute  বিতর্ক
disputed  বিতর্কিত
disquiet  অশান্ত
disrupt  সংহতিনাশ করা
disruption  সংহতিনাশ
disruptive  সংহতিনাশক
dissent  মত পার্থক্য
distance  দূরত্ব
distaste  অপছন্দ করা
distinct  আলাদা
distinction  স্বাতন্ত্র্য
distinguish  আলাদা করা
distort  বিকৃত করা
distortion  বিকৃতি
distribute  বন্টন করা
distributed  বণ্টিত
distributing  বন্টন
distribution  বন্টন
distributions  বন্টন
distributor  পরিবেশক
district  জেলা
districts  জেলা
disturb  বিরক্ত করা
dither  দ্বিধাগ্রস্ত
dive  ঝাঁপ দেওয়া
divergent  পৃথক
diverse  বিবিধ
diversified  বিবিধ
diversity  বৈচিত্র
divert  সরিয়ে নেওয়া
divide  বিভাজন
divide  ভাগ করা
dividend  ভাজ্য
division  বিভাগ
divorce  বিবাহবিচ্ছেদ
divorce  বিবাহ বিচ্ছেদ
do  কর
do  করা
do  করা
dock  ডক
dock  ডক করা
document  ডকুমেন্ট
document  নথি
document  নথী
documentation  ডকুমেনটেশন
documents  ডকুমেন্ট
dolce  মিষ্ট
doll  পুতুল
dollar  ডলার
domain  ডোমেন
dome  গম্বুজ
domestic  ঘরোয়া
dominate  পদদলিত করা
domination  কর্তৃত্ব
dominion  শাসন
donate  দান করা
done  সম্পন্ন
donkey  গাধা
donor  দাতা
donut  বৃত্তাকার একটি খাদ্য, ডোনাট
door  দরজা
doors  দরজা
dot  বিন্দু
dots  ফুটকি
double  দ্বিগুণ
doubt  দ্বন্দ্ব
doubt  সন্দিহান হওয়া
doubtful  সন্দেহজনক
down  নিচ
down  নিচে
downgrade  ডাউনগ্রেড
download  ডাউনলোড
download  ডাউনলোড করা
downloads  ডাউনলোড
downloaded  ডাউনলোডকৃত
downloading  ডাউনলোড
downtown  শহরতলী
dozen  ডজন
dozens  ডজন
draconian  নির্মম
draft  খসড়া
drag  টেনে নিয়ে যাওয়া
drag  টেনে নিয়ে যাওয়া
dragnet  টানাজাল
drain  বার করা
dramatic  নাটকীয়
dramatically  নাটকীয় ভাবে
draped  সজ্জিত
draught  ঔষধের মাত্রা
draw  আঁকা
draw  আঁকা
drawer  ড্রয়ার
drawing  ড্রয়িং
drawn  অঙ্কিত
dream  স্বপ্ন
dream  স্বপ্ন দেখা
dress  ড্রেস
drifting  ভেসে যাওয়া
drill  অনুশীলন
drink  পানীয়
drink  পান করা
drink  পান করা
drinking  পানীয়
drinking  পানীয়
drive  চালায়
drive  চালান
drive  চালনা করা
driven  চালিত
driver  চালক
drivers  ড্রাইভার
drives  চালায়
driving  চালনা
drone  পুরুষ মৌমাছি
drop  ফেলা
drop  ফোঁটা
drop  ফেলে দেওয়া
drought  অনাবৃষ্টি
drug  ড্রাগ
drugstore  ওষুধের দোকান
drum  ঢোল
drunk  মাতাল
dry  শুকনা
dual  দ্বৈত্ব
duct  নালী
dudgeon  ক্রোধ
due  বাকী
due  যথোচিত
due  পাওনা
dull  নিরানন্দময়
dumb  বোবা
dump  ফেলে দেওয়া
dump  ফেলে দেওয়া
dun  মেটে রঙ
dung  মল
duplicate  নকল
duplicate  নকল করা
durable  টেকসই
duration  সময়কাল
during  সময়ে
dutiful  কর্তব্যনিষ্ঠ
duty  কর্তব্য
dwarf  বামন
dwell  বাস করা
dweller  বাসিন্দা
dye  রং করা
dynamic  গতিশীল
dynamic  গতিময়
dynamically  চলন্ত অবস্থায়
dynamics  গতিবিদ্যা
dynastic  রাজবংশীয়
dynasties  রাজবংশ
dynasty  রাজবংশ
e.g  উদাঃ
each  প্রত্যেক
ear  কান
earlier  গোড়ার দিকে
earliest  যথাশীঘ্র
early  আগের
early  আগে
earn  আয় করা
earring  কানের দুল
earthbound  পৃথিবী অভিমুখী
earthly  সাংসারিক
earthquake  ভূকম্পন
easier  সহজতর
easily  সহজভাবে
east  পূর্ব
east  পূর্ব
eastern  পূর্ব
easy  সহজ
easy  সহজ
eat  খাওয়া
eatable  খাদ্য
eccentricity  উত্‍কেন্দ্রতা
eclectic  সঙ্কীর্ণতামুক্ত
eclipse  গ্রহণ
ecliptic  ক্রান্তিবৃত্ত
economic  অর্থনৈতিক
economics  অর্থনীতি
economy  অর্থব্যবস্থা
edge  কিনারা
edible  খাদ্য
edifice  অট্টালিকা
edit  এডিট
edited  সম্পাদিত
editing  সম্পাদন
edition  সংস্করণ
editor  সম্পাদক
editorial  সম্পাদকীয়
editors  সম্পাদক
educate  শিক্ষিত করা
educated  শিক্ষিত
education  শিক্ষা
educational  শিক্ষা সংক্রান্ত
educator  শিক্ষাবীদ
effect  প্রভাব
effective  কার্যকরী
effectively  কার্যকরভাবে
effectiveness  কার্যকারিতা
effects  প্রভাব
efficient  কুশলী
effort  কঠোর প্রচেষ্টা
effortless  অনায়াস
efforts  প্রচেষ্টা
egg  ডিম
eight  আট
eighteen  আঠেরো
eighteenth  অষ্টদশ
eighth  অষ্টম
either  হয়
eject  বের করে দেওয়া
eject  বের করে দেওয়া
ejecting  বের করছে
elapsed  অতিবাহিত
elasticity  নমনীয়তা
elated  উল্লসিত
elbow  কনুই
elder  বয়োজ্যেষ্ঠ
elect  নির্বাচিত করা
elected  নির্বাচিত
election  নির্বাচন
electric  বৈদ্যুতিক
electrically  বৈদ্যুতিকভাবে
electricity  তড়িৎ
electromagnet  তড়িৎ-চুম্বক
electromagnetism  তড়িৎ-চুম্বকীয় তত্ত্ব
electronic  ইলেকট্রনিক
electronics  ইলেকট্রনিক্স
electrons  ইলেকট্রন
elegant  রুচিশীল
element  উপাদান
elementary  প্রাথমিক
elephant  হাতি
elevation  উচ্চতা
elevator  লিফ্‌ট
eleven  এগার
eleventh  ১১তম
eligibility  যোগ্যতা
eligible  উপযুক্ত
eliminate  ধ্বংস করা
elimination  ধ্বংস
elite  অভিজাত
elongation  প্রতান
else  অন্যথায়
elsewhere  অন্য জায়গায়
elsewhere  অন্য কোথাও
emancipate  মুক্ত করা
embarrassment  নাকানিচোবানি
embassy  দূতাবাস
embedded  সন্নিবেশিত
emblem  প্রতীক
embryo  ভ্রূণ
emerge  উদ্ভূত হওয়া
emergency  জরুরী
emergency  জরুরী অবস্থা
emit  বের করা
emotion  আবেগ
emotional  আবেগতাড়িত
emperor  সম্রাট
emphasize  জোর দিয়ে বলা
empire  সাম্রাজ্য
empires  সাম্রাজ্য
empirical  প্রায়োগিক
empirically  অভিজ্ঞতাবলে
employ  চাকরী দেওয়া
employee  কর্মচারী
employees  কর্মচারী
employer  নিয়োগকর্তা
employment  কাজ
empowerment  ক্ষমতায়ন
empty  ফাঁকা
empty  ফাঁকা করা
emulate  অনুকরণ করা
emulated  অনুকরণকৃত
emulator  এমুলেটর
enable  সক্রিয়
enable  সক্রিয় করা
enabled  সক্রিয়
enables  সক্রিয় করে
enabling  সক্রিয়করণ
encircled  আবৃত
encode  এনকোডিং করা
encoded  এনকোডকৃত
encoding  এনকোডিং
encoder  এনকোডার
encompass  পরিবেষ্টন
encounter  সম্মুখীন হওয়া
encounter  সম্মুখীন হওয়া
encountered  সম্মুখীন হওয়া
encourage  উৎ‍সাহিত করা
encouraged  উৎ‍সাহিত
encouragement  উৎসাহ
encroach  জবরদখল করা
encyclopedia  বিশ্বকোষ
end  শেষ
end  প্রান্ত
end  শেষ হওয়া
endangered  বিপন্ন
ending  শেষাংশ
endings  শেষাংশ
endotoxin  এন্ডোটক্সিন
endowment  স্থায়ী বৃত্তি
enemy  শত্রু
energetic  কর্মশক্তিসম্পন্ন
energetically  সক্রিয়ভাবে
energy  শক্তি
enforce  বলবৎ করা
enforced  কার্যকরী
engage  নিযুক্ত করা
engender  জন্ম দেওয়া
engine  ইঞ্জিন
engineer  ইঞ্জিনিয়ার
engineer  প্রকৌশলী
engineering  পূর্তবিদ্যা
engineering  ইঞ্জিনিয়ারিং
engineers  প্রকৌশলী
engrave  খোদাই করা
engraved  খোদাইকৃত
engulf  গ্রাস করা
enhance  উন্নত করা
enhance  বৃদ্ধি করা
enhanced  বর্ধিত
enhancement  বর্ধিতকরণ
enhancements  উন্নতি
enigma  ধাঁধা
enjoy  উপভোগ করা
enlarge  বিশদ করা
enlargement  পরিবর্ধন
enlighten  আলোকিত করা
enlist  তালিকাভুক্ত করা
enmity  শত্রুতা
enormous  প্রকান্ড
enough  যথেষ্ট
enough  পর্যাপ্ত
enough  যথেষ্ট
ensue  উদ্ভূত হওয়া
ensure  নিশ্চিতকরণ
enter  ঢুকুন
entered  ঢোকানো
entering  প্রবেশ করা
enterprise  উদ্যোগ
enters  প্রবেশ করা
entertain  চিত্তবিনোদন করা
entertainment  বিনোদন
enthusiasm  উদ্যম
enthusiastic  কর্মঠ
entice  প্ররোচিত করা
entice  আকৃষ্ট করা
entire  সমগ্র
entirely  সমগ্রভাবে
entities  সত্ত্বা
entity  সত্ত্বা
entrance  প্রবেশ
entrepreneur  বিনিয়োগকারী
entrepreneurs  বিনিয়োগকারী
entries  এন্ট্রি
entry  অন্তর্ভুক্তি
envelope  খাম
envelopes  খাম
environment  পরিবেশ
environments  পরিবেশ
envisage  বিবেচনা করা
epic  মহাকাব্য
epics  মহাকাব্য
epicycle  মন্দবৃত্ত
episode  পর্ব
episodes  পর্ব
epitome  সার-সংক্ষেপ
epoch  যুগ
equal  সমান
equal  সমকক্ষ করা
equalize  সমকক্ষ করা
equalizer  ইকুয়ালাইজার
equally  সমানভাবে
equation  সমীকরণ
equations  সমীকরণ
equator  নিরক্ষরেখা
equatorial  নিরক্ষীয়
equity  সাম্যতা
equivalent  সমতুল্য
era  যুগ
eradicate  সমূলে উৎপাটিত করা
erase  মুছে ফেলা
erasing  মুছে ফেলা
erroneous  ত্রুটিপূর্ণ
error  ত্রুটি
errors  ত্রুটি
erstwhile  তৎকালীন
es  এস
escalate  ধাপে ধাপে বৃদ্ধি পাওয়া
esophagus  খাদ্যনালি
especially  বিশেষভাবে
essential  আবশ্যিক
establish  স্থাপন
established  প্রতিষ্ঠিত
establishing  স্থাপন করছে
establishment  প্রতিষ্ঠান
estimate  সম্ভাব্য ব্যয়ের হিসাব
estimate  হিসাব করা
estimated  আনুমানিক
etc  ইত্যাদি
etc.  ইত্যাদি
eternal  অনন্ত
ethnic  নৃতাত্বিক
euphemism  সুভাষণ
evaluate  মূল্যায়ন করা
evaluation  মূল্যায়ন
evaporation  বাষ্পীভবন
eve  আগের রাত
even  জোড়
even  এমনকি
even  সমতল
evening  সন্ধ্যা
event  ঘটনা
eventual  অবশ্যম্ভাবী
evenutally  পরিশেষে
ever  সর্বদা
ever  চিরকাল
every  প্রতি
everybody  সকলে
everyday  প্রাত্যহিক
everyone  সবাই
everything  সবকিছু
evict  আইন বলে উচ্ছেদ করা
evidence  প্রমাণ
evil  শয়তান
evolution  বিবর্তন
evolve  বিবর্ধিত হওয়া
exact  সঠিক
exact  যথার্থ
exactly  যথাযথভাবে
exalt  মহিমান্বিত করা
exam  পরীক্ষা
examination  পরীক্ষা
examine  পরীক্ষা করা
example  উদাহরণ
examples  উদাহরণ
excavation  খনন
exceed  অতিক্রম
excel  ছাড়িয়ে যাওয়া
excellence  মহত্ত্ব
excellence  মহানুভবতা
excellent  সর্বোৎকৃষ্ট
except  ব্যতীত
except  ছাড়া
exception  ব্যতিক্রম
exceptional  ব্যতিক্রমী
excerpt  উদ্ধতি
excessive  অতিরিক্ত
exchange  আদান প্রদান
exchange  বিনিময়
excited  উত্তেজিত
exclude  বাদ দেওয়া
exclusive  স্বতন্ত্র
exclusively  একচেটিয়াভাবে
execute  রান করা
executed  নিষ্পন্ন
execution  কার্যকর করা
executive  কার্যকরী
exempt  দায়মুক্ত
exercise  অনুশীলন
exercise  অনুশীলন করা
exercising  চর্চা
exhaustive  সম্পূর্ণ
exhibit  প্রদর্শন করা
exhibition  প্রদর্শনী
exile  নির্বাসন
exist  অস্তিত্ব থাকা
exist  বিদ্যমান
existed  ছিল
existence  অস্তিত্ব
existing  বিদ্যমান
exists  অস্তিত্ব রয়েছে
exit  প্রস্থান
exit  প্রস্থান করা
exiting  প্রস্থান করা হচ্ছে
exorcism  ঝাঁড়ফুক
expand  ছাড়ানো
expanded  সম্প্রসারিত
expands  সম্প্রসারিত হয়
expansion  বিস্তার
expansive  বিস্তৃত
expect  আশা করা
expect  আশা করা
expectable  প্রত্যাশিত
expected  প্রত্যাশিত
expectedly  প্রত্যাশিতভাবে
expecting  প্রত্যাশা করা হচ্ছে
expedite  ত্বরান্বিত করা
expel  বহিষ্কার করা
expenditure  খরচ
expense  খরচ
expenses  খরচা
expensive  মূল্যবান
expensive  দামী
experience  অভিজ্ঞতা
experience  অনুভব করা
experience  অভিজ্ঞতা হওয়া
experienced  অভিজ্ঞ
experiment  পরীক্ষা
experimental  পরীক্ষামূলক
expert  বিশেষজ্ঞ
expert  বিশেষজ্ঞ
experts  বিশেষজ্ঞরা
expiration  তামাদি
expire  তামাদি হওয়া
explain  ব্যাখ্যা করা
explain  বর্ণনা করা
explanation  ব্যাখ্যা
explicitly  স্পষ্টভাবে
explode  বিস্ফোরণ ঘটান
exploit  শোষণ করা
exploit  শোষণ করা
exploitation  শোষণ
explosion  বিস্ফোরণ
explosive  বিস্ফোরক
export  রপ্তানি
export  রপ্তানি করা
exported  রপ্তানীকৃত
expose  খুলে দেওয়া
expose  প্রকট করা
express  ব্যক্ত করা
express  ব্যক্ত করা
expression  মান
expressions  অভিব্যক্তি
extempore  চটজলদি
extend  প্রসারিত করা
extended  বর্ধিত
extension  বর্ধিতাংশ
extensions  বর্ধিতাংশ
extensive  ব্যাপক
extent  সীমা
external  বাহ্যিক
externally  বাহ্যিকভাবে
extinguish  নির্বাপন করা
extra  অতিরিক্ত
extract  নিষ্কাশন করা
extract  নিষ্কাশন করা
extracted  নিষ্কাশিত
extracting  নিষ্কাশন
extraction  নিষ্কাশন
extractor  নিষ্কাশনকারী
extraordinary  অসাধারণ
extreme  প্রচন্ড
extreme  চূড়ান্ত
extremely  প্রচন্ডভাবে
extremist  চরমপন্থী
extremity  প্রান্তে
extrovert  বহির্মুখী
eye  নয়ন
eyeball  অক্ষি গোলক
eyes  চোখ
fabric  গঠন
fabulous  অলীক
face  মুখ
face  মুখমন্ডল
face  সম্মুখীন হওয়া
facilities  সুবিধা
facility  সুবিধা
fact  ঘটনা
factor  ফ্যাক্টর
factory  ফ্যাক্টরি
factory  কারখানা
faculty  বিভাগ
fade  বিবর্ণ
fail  ব্যর্থ হ
fail  ব্যর্থ হওয়া
failed  ব্যর্থ
failed  ব্যর্থ হওয়া
failure  ব্যর্থতা
faint  ক্ষীণ
fair  অনুকূল
fair  মেলা
fairly  ভালভাবে
fairy  পরী
fairy.tale  পরীর গল্প
faith  বিশ্বাস
faithful  বিশ্বাসী
faithfully  যথাযথভাবে
fake  নকল
fall  পড়া
fall  পড়া
fallible  ভ্রমপ্রবণ
false  মিথ্যা
fame  সুনাম
famed  বিখ্যাত
familiar  পরিচিত
family  পরিবার
famous  বিখ্যাত
famously  বিখ্যাতভাবে
fan  পাখা
fancy  অভিনব
far  দূর
far  দুর
farewell  বিদায় সম্ভাষণ
farm  খামার
farm  গোলাবাড়ি
farmer  কৃষক
farmers  কৃষকগণ
fashion  ফ্যাশন
fast  দ্রুত
fast  দ্রুত
faster  দ্রুততর
fastness  দ্রুততা
fatal  মারাত্মক
fate  ভাগ্য
father  আব্বা
fault  দোষ
faultless  নিখুঁত
faults  দোষ
faulty  খারাপ
favor  প্রশ্রয়
favorite  প্রিয়
favorites  প্রিয়
favour  আনুকূল্য
favour  প্রশ্রয় দেওয়া
fawn  হরিণ-শিশু
fax  ফ্যাক্স
fear  ভয়
fear  ভয় করা
fear  ভয় করা
fearful  ভীতিজনক
feature  বৈশিষ্ট্য
featured  বিশিষ্ট
features  বৈশিষ্ট্য
federal  কেন্দ্রীয়
federally  কেন্দ্রীয়ভাবে
federation  ফেডারেশন
feed  জোগান দেওয়া
feedback  মন্তব্য
feeling  আবেগ
feet  ফুট
felicitous  সমৃদ্ধ
fellow  সহযোগী
female  মহিলা
feminine  স্ত্রীসুলভ
fence  বেড়া
fennel  মৌরী
fenugreek  মেথি
fermions  ফের্মিয়ন
fern  ফার্ণ
ferocious  হিংস্র
ferry  ফেরী
ferry  ফেরী করা
fertile  উর্বর
festival  উৎসব
festivals  উৎসব
festive  উল্লসিত
fetch  এনে দেওয়া
fetching  আনা হচ্ছে
fetid  দুর্গন্ধময়
fever  জ্বর
few  অল্প
fiber  তন্তু
fiberglass  রাসায়নিক পদ্ধতিতে কাঁচ দিয়ে তৈরি আঁশ 
fickle  চঞ্চল
fiction  বানোয়াট
fictional  কাল্পনিক
field  ক্ষেত্র
field  ক্ষেত্র
fields  ক্ষেত্র
fifteen  পনের
fifteenth  পঞ্চদশ
fifth  পঞ্চম
fifty  পঞ্চাশ
fig  ডুমুর
fight  লড়াই
fight  লড়াই করা
fight  লড়াই করা
fighter  লড়াকু
figure  চিত্র
file  ফাইল
file  দাখিল করা
files  ফাইল
fill  ভরাট করা
fill  ভর্তি করা
filled  ভর্তি
film  ছায়াছবি
filter  ফিল্টার
filter  ফিল্টার করা
filters  ফিল্টার
final  চূড়ান্ত
finality  চূড়ান্ত
finally  পরিশেষে
finance  রাজস্ব
financial  আর্থিক
find  সন্ধান করা
find  খুঁজে পাওয়া
finding  প্রাপ্তি
fine  সুন্দর
fines  জরিমানা
finger  আঙুল
fingerprint  আঙুলের ছাপ
finish  শেষ
finish  শেষ করা
finished  শেষ
finisher  সম্পন্নকারী
finishing  নিখুঁত করা
fire  আগুন
fireball  অগ্নিগোলক
firefighting  অগ্নি-নির্বাপণ
firewood  জ্বালানী কাঠ
firmness  অপরিবর্তনীয়তা
first  প্রথম
fish  মাছ
fishing  মাছ ধরা
fission  বিদারণ
fit  উপযোগী
fit  খাপ খাওয়া
fitted  উপযুক্ত
five  পাঁচ
fix  মেরামত করা
fix  মেরামত করা
fixable  ঠিক করা যায় এমন
fixed  স্থায়ী
flag  ফ্ল্যাগ
flagship  প্রধান জাহাজ
flame  দাহ করা
flammable  দাহ্য
flare  দাউদাউ করে জ্বলা
flash  ফ্ল্যাশ
flat  চ্যাপ্টা
fleet  নৌবহর
flesh  মাংস
flexible  নমনীয়
flick  দপদপ করা
flight  উড়ান
flights  উড়ান
flimsy  তুচ্ছ
flip  উল্টানো
flip  ওলটান
flirtatious  বাচাল
float  ভাসা
floating  ভাসমান
flock  ভিড় করা
flood  বন্যা
flood  প্লাবিত হওয়া
floor  মেঝে
floppies  ফ্লপি
floppy  ফ্লপি
flounder  হাক পাক করা
flour  আটা
flourish  উন্নতিলাভ করা
flourish  উন্নতিলাভ করা
flow  বয়ে চল
flower  ফুল
flu  ফ্লু
fluctuations  ওঠা নামা
fluid  তরল
fluid  তরল
flush  ফ্লাশ করা
flute  বাঁশি
fly  মাছি
fly  ওড়া
foam  ফেনা
focus  নির্দিষ্ট করা
focus  ফোকাস করা
focus  কেন্দ্রবিন্দু
fodder  গোখাদ্য
foggy  কুয়াশাচ্ছন্ন
fold  ভাজ
fold  ভাজ করা
folder  ফোল্ডার
folders  ফোল্ডার
folding  ভাঁজ করার সুবিধাযুক্ত
folio  পৃষ্ঠাসংখ্যা
folk  লোক
folklore  উপকথা
follow  অনুসরণ করা
followed  অনুসৃত
follower  অনুসারী
following  নিম্নলিখিত
following  পরবর্তী
foment  গজগজ করা
font  ফন্ট
fonts  ফন্ট
food  খাদ্য
foodstuff  খাদ্যবস্তু
fool  বোকা
foolish  নির্বোধ
foot  হাঁটা
footage  ফুটের মাপে দৈর্ঘ্য
football  ফুটবল
footballer  ফুটবলার
footwear  জুতো
for  জন্য
forage  পশুখাদ্য
foray  হানা দেওয়া
forbid  নিষেধ করা
forbid  নিষেধ করা
forbidden  নিষিদ্ধ
forborne  বিরত থাকা
force  বল
force  বাধ্য করা
forced  বহুশ্রমসাধ্য
forcefulness  শক্তিমানতা
forces  শক্তিসমূহ
forcibly  বলপ্রয়োগ করে
fore  অগ্রবর্তী
forecast  পূর্বাভাস
foreground  উপরের অংশ
foreign  বিদেশী
foreigner  বিদেশী
foremost  প্রধান
forest  বন
forestry  বনবিদ্যা
forever  চিরকালীন
forget  ভুলে যা
forgetful  বিস্মরণশীল
forgo  ত্যাগ করা
forgotten  ভুলে যাওয়া
fork  কাটা চামচ
forlorn  পরিত্যক্ত
form  আকার
form  সংগঠিত করা
formally  প্রথাগতভাবে
format  কাঠামো
format  ছাঁদ
formation  গঠন
formations  গঠন
formats  বিন্যাস
formatted  ফরম্যাটকৃত
formatting  ফরম্যাট করছে
formed  গঠিত
former  প্রাক্তন
formerly  ইতঃপূর্বে
forms  আকৃতি
forms  রূপ
formula  ফর্মূলা
fort  দুর্গ
forthwith  তৎক্ষণাৎ
fortune  দৈব্য
forty  চল্লিশ
forum  আলোচনাচক্র
forums  আলোচনাচক্র
forward  ফরওয়ার্ড
forward  সামনে
forwards  সামনে
fossil  জীবাশ্ম
foster  প্রতিপালিত
foul  জঘন্য
foundation  ফাউন্ডেশন
founded  স্থাপিত
founder  প্রতিষ্ঠাতা
foundry  ঢালাই কারখানা
fountain  ফোয়ারা
four  চার
fourteenth  ১৪তম
fourth  চতুর্থ
fox  শিয়াল
fps  এফ-পি-এস
fraction  ভগ্নাংশ
fractured  চুর্ণীভূত
fragrance  সৌরভ
frail  ভঙ্গুর
frame  ছাঁচ
frame  ফ্রেম
framework  কাঠামো
fraud  প্রতারণা
freak  রঙ্গ
freak  রঙ্গ করা
free  ছেড়ে দেয়া
free  মুক্ত
free  ফাঁকা থাকা
freedom  স্বাধীনতা
freely  মুক্তভাবে
freezing  অতি শীতল
french  ফরাসী
frenzy  প্রবল উত্তেজনা
frequencies  কম্পাঙ্ক
frequency  কম্পাংক
frequent  নিয়মিত
frequently  ঘনঘন
fresh  তাজা
fridge  ফ্রিজ
friendly  বন্ধুভাবাপন্ন
friendship  বন্ধুত্ব
fright  আতঙ্ক
frivolously  তুচ্ছভাবে
frog  ব্যাঙ
from  থেকে
front  সদর
frontend  ফ্রন্ট-এন্ড
frosting  হিমান্কের নীচে নেমে যাওয়া তাপমাত্রা
froth  ফেনা
fructose  ফলশর্করা
fruit  ফল
fruitful  ফলপ্রসূ
fruitless  নিষ্ফলা
ft  ফুট
fuck  যৌনসঙ্গম
fuel  ইন্ধন
fueloil  জ্বালানী তেল
full  পূর্ণ
full  সম্পূর্ণ
fullest  পূর্ণতম
fully  সম্পূর্ণভাবে
fun  মজা
function  কাজ
fundamental  মৌলিক
fundamentalism  মৌলবাদ
funeral  শেষকৃত্য
funniest  হাস্যকর
furious  ক্রোধোন্মত্ত
furnace  চুল্লি
furniture  আসবাবপত্র
further  আরও
fusion  জোড়া লাগানো 
fussy  বিরক্তিকর
future  ভবিষ্যৎ‍‌
fuzzy  অস্পষ্ট
g  জি
gadget  ছোট যন্ত্র
gain  লাভ
gain  লাভ করা
gains  লাভ
galaxy  ছায়াপথ
gallery  গ্যালারি
galloping  দ্রুতবেগে ধাবমান
game  খেলা
games  খেলা
gang  দল
ganglion  স্নায়ু-গ্রন্থি
gangster  গুন্ডা
gap  ফাঁক
garbage  জজ্ঞাল
garland  মালা
garment  পোষাক
garments  পোষাক
gas  গ্যাস
gate  দরজা
gateway  গেটওয়ে
gather  সমবেত
gather  একত্রিত করা
gauge  গেজ
gay  সমকামী
gazelle  গাজলা হরিণ
gegenschein  প্রতিদীপ্তি
gem  রত্ন
gems  রত্ন
gender  লিঙ্গ
gender  লিঙ্গ
gene  জিন
general  সাধারণ
generally  সাধারণত
generating  তৈরি করা হচ্ছে
generation  উৎ‍পাদন
generator  উৎ‍পাদক
generic  সাধারণ
generous  উদার
generously  উদারভাবে
genie  জিন
genius  প্রতিভাবান
genocide  গণহত্যা
genre  গোত্র
gentleman  ভদ্রলোক
gentleness  ভদ্রতা
gently  আলতোভাবে
genus  বর্গ
geocentric  ভূকেন্দ্রিক
geographical  ভৌগলিক
geography  ভূগোল
geologic  ভূতাত্ত্বিক
geological  ভূতাত্ত্বিক
geology  ভূতত্ত্ব
geometric  জ্যামিতিক
geometry  জ্যামিতি
germ  জীবাণু
germinated  অঙ্কুরিত
get  পাওয়া
getting  আনছে
ghazal  উর্দু কবিতা
ghetto  শহরের দরিদ্র বস্তি এলাকা
ghost  ভূত
giant  দৈত্য
gibberish  হ-য-ব-র-ল
giddy  মাথা ঘোরা
gift  দান
gifted  প্রতিভাবান
gimmick  চটকদার বস্তু
ginger  আদা
girl  বালিকা
give  দেওয়া
give  দেওয়া
given  প্রদত্ত
glacier  হিমবাহ
glad  আনন্দিত
gladness  আনন্দ
glance  দৃষ্টি
glass  কাঁচ
glassware  কাঁচের বাসন
global  বিশ্বজনীন
globally  বিশ্বব্যাপী
globe  পৃথিবী
gloss  গ্লস
glow  প্রভা
glucose  গ্লুকোজ
glycol  গ্লাইকল
gnome  গনোম
go  চলা
go  যাওয়া
goal  লক্ষ্য
goat  ছাগল
god  আল্লাহ্
goddess  দেবী
godlike  দেবোপম
godliness  ধার্মিকতা
gold  সোনা
golden  সুবর্ণ
goldsmith  স্বর্ণকার
golf  গল্ফ
gone  অতীত
good  ভাল
gore  জমাট বাধা রক্ত
gorilla  গরিলা
gospel  দৈববাণী
gossip  গালগল্প
govern  শাসন করা
governess  গৃহশিক্ষিকা
governing  শাসক
government  সরকার
governmental  সরকারি
governor  রাজ্যপাল
grab  ধরা
grace  দয়া
grade  স্তর
gradient  নতি
gradients  ঢালের মাত্রা
grading  স্তর অনুসারে সাজানো
gradual  ক্রমশঃ অগ্রশীল
gradually  ধীরে ধীরে
graduate  স্নাতক
graduate  পাস করা
grain  দানা
grammar  ব্যাকরণ
grammatical  ব্যাকরণগত
grand  বৃহৎ
grandchild  নাতি
grandfather  ঠাকুরদা
grant  প্রদান
grant  প্রদান করা
granular  দানাদার
grape  আঙুর
grapefruit  আঙুর 
graph  গ্রাফ
graphic  গ্রাফিক
graphical  গ্রাফিকাল
graphics  চিত্রছবি
grasp  উপলব্ধি
grasp  উপলব্ধি করা
grass  ঘাস
gratify  খুশি করা
gratis  বিনামূল্যে
gratitude  কৃতজ্ঞতা
grave  কবর
gravid  গাভিন
gravitation  মহাকর্ষ
gravitational  মহাকর্ষীয়
gravity  মহাকর্ষ
gray  ধূসর
gray  ধূসর
graybeard  বৃদ্ধলোক
great  মহান
greatly  অত্যন্ত
greed  লোভ
greedy  লোভী
green  সবুজ
greenest  সবুজতম
greet  অভিবাদন
greeting  অভ্যর্থনা
grin  মুচকি হাসি
grin  মুচকি হাসা
grinding  চূর্ণ করা
grotesquely  বীভৎস্য ভাবে
ground  মাঠ
groundless  ভিত্তিহীন
groundwork  ভিত্তি
group  শ্রেণী
group  গ্রুপ
group  দল
grouping  শ্রেণীবিভাগ
groups  দল
grow  বৃদ্ধি
growing  বাড়ন্ত
growth  বৃদ্ধি
guarantee  নিশ্চয়তা
guarantee  নিশ্চয়তা প্রদান করা
guard  রক্ষা করা
guard  রক্ষা করা
guardian  অভিভাবক
guess  আন্দাজ
guess  অনুমান করা
guess  অনুমান করা
guest  অতিথী
guests  অতিথি
guide  সহায়িকা
guide  পরিচালনা করা
guideline  নির্দেশাবলী
guilty  দোষী
guinea  গিনি
gullet  খাদ্যনালি
gum  মাড়ি
gun  বন্দুক
gunman  বন্দুকধারী
gunmen  বন্দুকধারী
guy  লোক
gypsum  ক্যালসিয়াম সালফেটের একটি খনিজ পদার্থ
habit  অভ্যাস
habits  অভ্যাস
hail  অভিনন্দন জানান
hail  অভিনন্দন জানানো
hair  চুল
hairpiece  টুপি
half  অর্ধেক
halo  জ্যোতিশ্চক্র
ham  শুকরের মাংস
hammer  হাতুড়ি চালান
hammer  হাতুড়ি
hamper  বড় ঝুড়ি
hand  হাত
hand  হাত
hand  হাত
handbook  গাইডবই
handbooks  গাইডবই
handed  হস্তান্তরকৃত
handicrafts  হস্তশিল্প
handle  হাতল
handle  হ্যান্ডল
handlers  পরিচালক
handling  পরিচালন
handshake  হাত মেলানো
handsome  সুদর্শন
handy  কাজের
hang  ঝোলান
hang  ঝোলান
hanging  ঝুলন্ত
hanging  ঝুলন্ত
happen  ঘটা
happen  সংঘটিত হওয়া
happening  ঘটনা
happiness  সুখ
happy  সুখী
hard  শক্ত
harddisk  হার্ড ডিস্ক
hardship  প্রতিকূলতা
harm  ক্ষতি
harm  ক্ষতি করা
harmful  ক্ষতিকর
harmless  নিরীহ
harmonic  ঐকতান
harmony  সম্প্রীতি
harvest  ফসল ফলানো
has  আছে
has  আছে
hash  হ্যাশ
hash  হ্যাশ করা
hashing  হ্যাশিং
hastily  দ্রুতভাবে
hat  টুপি
hate  ঘৃণা কর
hate  ঘৃণা করা
hate  ঘৃনা করা
haul  বহন করা
hauling  বহন
have  আছে
having  থাকা
hawker  ফেরিওয়ালা
hawking  হকিং
he  সে
head  মাথা
head  প্রধান
head  নেতৃত্ব দেওয়া
headache  মাথা ব্যাথা
header  শিরোনাম
heading  শিরোনাম
headings  শিরোনাম
headline  শিরোনাম
headlines  শিরোনাম
headquarters  সদর
healer  আরোগ্যকারী
health  স্বাস্থ্য
healthcare  স্বাস্থ্যপরিশেবা
healthy  স্বাস্থ্যসম্মত
hear  শোনা
hearsay  গুজব
heart  হৃদয়
heartstopping  হৃদয়বিদারী
heat  তাপ দেওয়া
heated  গরমকৃত
heaven  স্বর্গ
heavier  অধিকতর ওজনদার
heaviest  সর্বোচ্চ ওজনদার
heavy  ভারী
heavyweight  হভিওয়েট
height  উচ্চতা
heinous  ঘৃণ্য
held  ধরা
helicopter  হেলিকপ্টার
helix  হেলিক্স
hell  দোযখ
hell  নরক
hellfire  দোযখের আগুন
hello  শুনুন
hello  ওহে
help  সহায়ক তথ্য
helper  সহায়তাকারী
helpful  সহায়ক
hence  তাই
hepatitis  হেপাটাইটিস
hepatitis  হেপাটাইটিস
her  তার
herald  আগমনবার্তা ঘোষণা করা
herbal  ভেষজ
herd  পশুর দল
here  এখানে
heritage  ঐতিহ্য
hero  নায়ক
heroic  বীরোচিত
heroically  বীরত্বপূর্ণভাবে
heroine  নায়িকা
heroism  বীরত্ব
hesitate  ইতস্ততঃ করা
hey  ওহে
hibernate  জড়ভাবে শীত কাটানো
hiccup  হিচকি
hidden  লুকানো
hidden  লুক্কায়িত
hide  আড়াল করা
hide  গোপন করা
hide  লুকোন
hierarchy  ক্রমোচ্চ শ্রেণীবিভাগ
high  উচ্চ
high  উঁচু
high.quality  উচ্চ গুনমানসম্পন্ন
higher  আরো উঁচু
highest  সর্বোচ্চ
highlighted  চিহ্নিত
highly  উচ্চভাবে
highway  মহাসড়ক
highways  মহাসড়ক
hike  পায়ে হাটা
hill  ছোট পাহাড়
hilly  পার্বত্য
him  তার
hindrance  অন্তরায়
hint  আভাস
hint  ইঙ্গিত
hired  ভাড়াটে
historian  ইতিহাসবিদ
historic  ঐতিহাসিক
historical  ঐতিহাসিক
historically  ঐতিহাসিকভাবে
history  ইতিহাস
hit  আঘাত
hobby  শখ
hockey  হকি
hold  ধরা
hold  ধরা
holder  ধারক
holders  ধারক
hold  ধরা
hole  গর্ত
holes  গহ্বর
holiday  ছুটির দিন
holidays  ছুটির দিন
holocaust  খান্ডবদহণ
holster  খাপ
holy  পবিত্র
home  বাড়ি
home  বাড়ি
home  গৃহাগমন করা
home  স্বদেশ যাওয়া
homebuilder  বাড়ি নির্মাতা
homeland  মাতৃভূমি
homeless  গৃহহীন
homemade  ঘরের তৈরি
homeownership  বাড়ির মালিকানা
homicidal  নরঘাতী
homosexual  সমকামী
homosexual  সমকামী
honest  সৎ
honey  মধু
honeymoon  মধুচন্দ্রিমা
honor  সম্মান
honorable  সম্মানিত
honorary  অবৈতনিক
honored  সম্মানিত
honour  সম্মান
hoodlum  গুন্ডা
hope  আশা
hope  আশা করা
hopeful  আশাবাদী
hopes  আশা
horizon  দিগন্ত
horizontal  আনুভূমিক
horizontal  আনুভূমিক
horizontally  অনুভূমিকভাবে
hornet  ভিমরুল
horrible  জঘন্য
horribly  ভয়ঙ্করভাবে
horse  ঘোড়া
horseman  অশ্বারোহী
hospitality  আতিথেয়তা
host  হোস্ট
host  আমন্ত্রক
hostage  পণবন্দী
hostess  অতিথিসেবক
hostile  প্রতিকূল
hostile  শত্রুভাবাপন্ন
hosting  হোস্টিং
hosts  আয়োজন করে
hot  গরম
hour  ঘন্টা
hours  ঘন্টা
house  আশ্রয় দেওয়া
houseboat  ভাসমান বাড়ি
household  ঘরোয়া
housekeeping  গৃহপরিচর্যা
housewife  গৃহবধূ
how  কেমন
however  তাহলেও
howl  গর্জন করা
hub  কেন্দ্র
huddle  গাদাগাদী করে থাকা
hue  রঙের সূক্ষ তারতম্য
huge  বিশাল
hugely  বিশালভাবে
hullabaloo  চেঁচামেচি
human  মানবিক
human  মানুষ
human.rights  মানবাধিকার
humane  মানবিক
humanitarian  মানবিক
humanity  মনুষ্যত্ব
humanly  মানবিকভাবে
humblest  নম্রতম
humid  আর্দ্র
humidity  আর্দ্রতা
humorist  রসিক
hundred  শত
hundreds  শতশত
hunger  ক্ষুধা
hungry  ক্ষুধার্ত
hunt  শিকার করা
hunt  শিকার করা
hunting  শিকার করা
hurl  সজোরে নিক্ষেপ করা
hurry  দ্রুত অগ্রসর হওয়া
hurt  বেদনা দেওয়া
hurt  আহত করা
hurt  আঘাত করা
husband  স্বামী
hutch  হাচ
hybrid  সঙ্কর
hyperactive  অতিসক্রিয়
hypocrite  ভন্ড
hypothesis  অনুমান
hypothetical  কাল্পনিক
ice  বরফ
ice  বরফ
icebox  বরফের বাক্স
icon  আইকন
icons  আইকনস্
icy  বরফ-শীতল
idea  ধারনা
ideal  আদর্শ
idealism  ভাববাদ
ideally  আদর্শভাবে
identical  অনুরূপ
identification  পরিচয়
identifier  চিহ্নিত
identify  সনাক্ত করা
identity  পরিচয়
idle  অলস
idol  প্রতিমা
idolize  আরাদ্ধ বস্তুতে পরিণত করা, দেবতা জ্ঞানে পুজা করা
if  যদি
ignorance  অবহেলা
ignore  উপেক্ষা
ignoring  উপেক্ষা করছে
ill  অসুস্থ
ill  অসুস্থ
illegal  বেআইনি
illness  অসুস্থতা
illusion  মরীচিকা
illustrate  অলংকরণ করা
illustrates  আঁকা
illustration  অলংকরণ
illustrator  আঁকিয়ে
image  চিত্র
image  ছবি
images  চিত্র
imagination  কল্পনা
imagine  কল্পনা করা
imbibe  পান করা
imitate  নকল করা
immeasurable  অপরিমেয়
immediate  অবিলম্বে
immediately  তাৎ‍ক্ষণিকভাবে
immensely  প্রকান্ডভাবে
immigrant  অভিবাসী
immigrants  অভিবাসী
imminent  আসন্ন
imminently  সমুপস্হিতরুপে
immune  অনাক্রম্য
immune.system  অনাক্রম্য সিস্টেম
immutable  অপরিবর্তনীয়
impact  ধাক্কা
impact  ধাক্কা দেওয়া
impaired  দুর্বল
impatient  অধৈর্য
impatient  অধীর
imperialist  সাম্রাজ্যবাদী
implement  বাস্তবায়ন
implementation  বাস্তবায়ন
implicit  পরোক্ষ
imply  ইঙ্গিত করা
impolite  অভদ্র
import  আমদানি
import  আমদানি করা
importance  গুরুত্ব
important  গুরুত্বপূর্ণ
importantly  গুরুত্বপূর্ণভাবে
imported  আমদানীকৃত
importing  আমদানি করা হচ্ছে
impose  আরোপ করা
imposed  আরোপিত
imposing  চিত্তাকর্ষক
impossible  অসম্ভব
impossibly  অসম্ভবভাবে
impregnable  অভেদ্য
impress  রেখাপাত করা
impressionist  রূপবাদী চিত্রকর
imprisoned  বদ্ধ
imprisonment  গারদ
improper  বেঠিক
improperly  অসঙ্গতভাবে
improve  উন্নতি করা
improved  উন্নত
improvement  উন্নতি
improvements  উন্নতি
improving  উন্নতিশীল
impure  দূষিত
inaccurate  বেঠিক
inactivate  নিষ্ক্রিয় করা
inactive  নিষ্ক্রিয়
inadequate  অপর্যাপ্ত
inappropriate  বেমানান
inauguration  উদ্বোধন
incalculable  অপরিমেয়
incapable  অক্ষম
incapable  অযোগ্য
incentive  উদ্দীপনা
incest  আত্মীয়ের মধ্যে শারীরিক মিলন
inch  ইঞ্চি
inches  ইঞ্চি
incident  ঘটনা
incidental  প্রাসঙ্গিক
incidentally  ঘটনাক্রমে
incipience  সৃষ্টি
incitement  উত্তেজনা
inclination  নতি
include  অন্তর্ভুক্ত করা
included  অন্তর্ভুক্ত
includes  অন্তর্ভুক্ত
including  সহ
inclusion  অন্তর্ভুক্তি
incoherent  খাপ-ছাড়া
income  আায়
incoming  আগমনরত
incoming  অন্তর্মুখী
incompatibility  অসঙ্গতি
incompatible  সামঞ্জস্যহীন
incompetent  অযোগ্য
incomplete  অসম্পূর্ণ
incompletely  অসম্পূর্ণভাবে
incompleteness  অপরিপূর্ণতা
inconsiderable  অবিবেচ্য
inconsistent  খাপ-ছাড়া
inconvenience  অসুবিধা
inconvenient  অসুবিধাজনক
incorporated  একত্রীভূত
incorrect  বেঠিক
incorrectly  বেঠিকভাবে
increase  বৃদ্ধি
increase  বৃদ্ধি করা
increased  অধিক
increases  বৃদ্ধি
increasingly  ক্রমবর্ধমানভাবে
incredible  অবিশ্বাস্য
incredulity  অবিশ্বাস
incremental  ক্রমবর্ধিষ্ণু
indeed  বাস্তবিকপক্ষে
indefinite  অনির্দিষ্ট
indefinitely  অনির্দিষ্টভাবে
independence  স্বাধীনতা
independent  নিরপেক্ষ
independent  স্বাধীন
independently  স্বাধীনভাবে
indeterminate  অনির্ণীত
index  সূচিপত্র
indicate  নির্দেশ করা
indicated  নির্দেশিত
indicates  নির্দেশ করে
indication  ইঙ্গিত
indicator  নির্দেশক
indicators  নির্দেশক
indict  অভিযুক্ত করা
indirect  পরক্ষ
indispensable  অপরিহার্য
individual  ব্যক্তিগত
individually  নিজস্বভাবে
indivisible  অবিভাজ্য
industrial  শ্রমশিল্পসংক্রান্ত
industries  শ্রমশিল্প
industry  শিল্প
inedible  অখাদ্য
ineptness  অসারতা
inertia  জড়তা
inexact  বেঠিক
inexpensive  সস্তা
infamous  কুখ্যাত
infant  শিশু
infatuation  মোহ
infect  সংক্রামিত করা
infected  সংক্রামিত
infectious  সংক্রামক
infer  অনুমান করা
inferable  অনুমেয়
inference  অনুসিদ্ধান্ত
inferential  অনুমানসিদ্ধ
infertile  অনুর্বর
infinite  অনন্ত
infinitesimal  ক্ষুদ্রাদপিক্ষুদ্র
infinity  অসীম
inflation  মুদ্রাস্ফীতি
inflict  প্রদান করা
inflow  অন্তঃপ্রবাহ
influence  প্রভাব
influence  প্রভাবিত করা
influential  প্রভাবশালী
influenza  ইনফ্লুয়েঞ্জা
inform  জানানো
informally  অনানুষ্ঠানিক ভাবে
information  তথ্য
informational  তথ্যভুল
informs  জানায়
infrared  অবলোহিত
infrastructure  পরিকাঠামো
infringement  বিধিলঙ্ঘন
infuse  পরিপৃক্ত করা
ingredient  উপকরণ
inherit  উত্তরাধিকারসূত্রে পাওয়া
inherited  উত্তরাধিকার সুত্রে প্রাপ্ত
inhibitor  দমনকারী
inimitable  অননুকরণীয়
initial  প্রাথমিক
initialize  চালু করা
initialized  সচল
initializing  চালু করা
initially  প্রাথমিকভাবে
initiate  চালুকরণ
initiative  প্রবর্তন
injure  আহত করা
injure  আহত করা
injured  আহত
injury  আঘাত
injustice  অবিচার
ink  কালি
inmate  বাসিন্দা
innate  সহজাত
inner  অভ্যন্তরীণ
innings  ইনিংস
innocent  নির্দোষ
innovate  নতুন কিছুর প্রবর্তন করা
innovation  উদ্ভাবন
innovations  উদ্ভাবন
innovative  প্রবর্তক
input  ইনপুট
inquiry  অনুসন্ধান
insect  পতঙ্গ
insecticide  কীটনাষক
insensitive  অসংবেদী
insert  ঢোকানো
insert  ভিতরে ঢোকান
inserted  সন্নিবেশিত
insertion  ঢোকানো
inside  অভ্যন্তরে
inside  ভেতরে
insight  পরিজ্ঞান
insignificant  তুচ্ছ
insinuation  ধীরে ধীরে সুকৌশলে অভ্যন্তরপ্রবেশ, বক্রোক্তি
insist  পিড়াপিড়ি করা
insistent  জেদি
inspect  পরিদর্শন করা
inspect  পরিদ‌র্শন করা
inspection  পরিদর্শন
inspiration  প্রেরণা
inspire  অনুপ্রাণিত করা
inspired  অনুপ্রেরিত
instability  অস্থিরতা
install  ইনস্টল
installation  ইনস্টলেশন
installed  ইনস্টল করা আছে
installed  ইনস্টলকৃত
installer  ইনস্টলার
installment  কিস্তি
instance  উদাহরণ
instances  উদাহরণ
instant  তাৎক্ষণিক
instant  মুহূর্ত
instantly  তাৎক্ষনিকভাবে
instead  পরিবর্তে
instinctual  সহজাতপ্রবৃত্তি-জনিত
institute  সংস্থা
institutes  সংস্থা
institution  সংস্থা
instruction  নির্দেশনা
instructions  নির্দেশাবলী
instrument  যন্ত্র
instrumentally  যান্ত্রিকভাবে
instruments  যন্ত্র সমূহ
insufficient  অপর্যাপ্ত
insult  অপমান
insult  অপমান করা
insurgency  বিদ্রোহ
insurgent  বিদ্রোহ
intangible  অলীক
intangible  অলীক
integer  পূর্ণসংখ্যা
integral  অখন্ড
integration  একত্রীকরণ
integrity  শুদ্ধতা
intellectual  বুদ্ধিজীবি
intellectually  বুদ্ধিমত
intelligence  মেধা
intelligent  মেধাবী
intelligentsia  বুদ্ধিজীবী-সম্প্রদায়
intend  মনস্থ করা
intended  উদ্দেশ্যে
intensify  জোরদার করা
intensity  তীব্রতা
intensive  তীব্র
intensive  প্রগাড়
intent  উদ্দেশ্য
intention  অভিপ্রায়
intentionally  ইচ্ছাকৃত
inter  আন্ত
interaction  পারস্পরিক যোগাযোগ
interactions  মিথষ্ক্রিয়া
intercept  ধাওয়া করা
interchange  বিনিময়
intercity  আন্তঃশহর
interconnect  পরস্পরের মধ্যে সংযোগ সাধন করা
intercourse  যৌন-সহবাস
interest  আগ্রহ
interested  কৌতূহলী
interesting  উৎসাহজনক
interface  ইন্টারফেস
interfaces  ইন্টারফেস
interim  অন্তর্বর্তীকালীন
interior  অভ্যন্তরীণ
interlude  গর্ভাভিনয়
intermediate  মধ্যবর্তী
internal  অভ্যন্তরীণ
internally  অভ্যন্তরীণভাবে
international  আন্তর্জাতিক
internationalization  আন্তর্জাতিকীকরণ
internationally  আন্তর্জাতিকভাবে
interplay  মিথস্ক্রিয়া
interpret  ব্যাখ্যা করা
interrogate  জিজ্ঞাসাবাদ করা
interrupt  মাঝপথে বাধা দেওয়া
interruption  মাঝপথে বাধা দেওয়া
intersect  পরস্পর ছেদ করা
interval  বিরতি
interview  সাক্ষাৎকার
intestine  অন্ত্র
intimation  অন্তরঙ্গতা
intimidate  ভয় দেখান
into  মধ্যে
into  মধ্যে
intonation  কথা বলার সময় কন্ঠস্বরের ওজনের উত্থান-পতন
introduce  উপস্থাপন
introduction  ভূমিকা
intrusive  অনধিকার প্রবেশমূলক
institution  প্রতিষ্ঠান
intuitive  স্বতঃস্ফুর্ত
invader  হানাদার
invaders  হানাদার
invalid  অবৈধ
invalid  ত্রুটিযুক্ত
invalid  বেঠিক
invaluable  অমূল্য
invariable  অপরিবর্তনীয়
invariably  অপরিবর্তনীয়ভাবে
invariant  অপরিবর্তনীয়
invent  উদ্ভাবন করা
invention  উদ্ভাবনা
inverse  বিপরীত
inverse  বিপরীত
inversely  বিপরীতক্রমে
invert  বিপরীত অবস্থায় আনা
invest  বিনিয়োগ করা
investigation  তদন্ত
investigator  তদন্তকারী
investment  বিনিয়োগ
investment  বিনিয়োগ
invincible  অজেয়
invisible  অদৃশ্য
invitation  আমন্ত্রণ
invite  আমন্ত্রণ করা
involve  অন্তর্ভুক্ত
involve  জড়িত করা
inward  ভিতরের দিকে
ionized  আয়নিত
ionosphere  আয়নমণ্ডল
ip  অাই.পি.
irk  বিরক্ত করা
irregular  অনিয়মিত
irrelevant  খাপ-ছাড়া
irrepressible  অদম্য
irresistable  দুর্দম
irresistibly  অপ্রতিরোধ্যভাবে
irretrievably  অপূরণীয়ভাবে
irreversibly  চিরতরে
irrigate  জল সেচ করা
irritate  জ্বালাতন করা
island  দ্বীপ
islands  দ্বীপপুঞ্জ
isocyanate  আইসো-সায়ানেট
isolated  বিচ্ছিন্ন
issue  বিষয়
issue  প্রচার করা
it  এটা
italics  ইটালিক
itch  চুলকানো
itchy  চুলকায় এমন
item  পদ
items  পদগুলো
items  বস্তু
its  তার
jacket  জ্যাকেট
jagged  অসমতল ভুমি, খাঁজ কাটা
jail  জেল
jail  কারারুদ্ধ করা
jailed  জেলবন্দী
jailhouse  জেলখানা
jam  ঠাসাঠাসি করা
jar  জার
java  জাভা
jaw  চোয়াল
jawbone  চোয়াল
jealousy  জ্বলন
jellyfish  জেলিফিশ
jest  পরিহাস
jetty  জাহাজঘাটা
jewel  রত্ন
jeweler  জহুরী
jinx  অপয়া
job  কাজ
jobs  কর্ম
jocular  রসিক
john  জন
join  যুক্তকরণ
joining  যুক্ত করা
joint  যৌথ
joke  কৌতুক
joke  পরিহাস করা
joke  ঠাট্টা করা
jokingly  পরিহাসভরে
jolly  প্রফুল্ল
journalism  সাংবাদিকতা
journalist  সাংবাদিক
journalistic  সাংবাদিকসুলভ
jovial  আমুদে
joyful  আনন্দময়
jubilation  আনন্দো